πρὶν	c--------	d--------
τῳ	p-s---md-	p-s----d-
ἐγὼ	p-s---fn-	p1s---mn-,p1s---fn-,p1s---mv-,p1s---fv-
Αἰτωλὶς	a-s---fn-	n-s---fn-
μοι	p-s---fd-	p1s---md-,p1s---fd-
τρισὶν	m--------	m-p---md-,m-p---fd-,m-p---nd-
με	p-s---fa-	p1s---ma-,p1s---fa-
ἥμην	v1siie---	v1slim---,v1siim---
τοιοῦτος	a-s---mn-	p-s---mn-
μάλιστα	d-------s	d--------
ἡμεῖς	p-p---fn-	p1p---mn-,p1p---fn-,p1p---mv-,p1p---fv-
οὐδεὶς	a-s---mn-	p-s---mn-,p-s---mv-
ἐμοὶ	p-s---fd-	p1s---md-,p1s---fd-,a-p---mn-,a-p---mv-
αὐτοῦ	a-s---mg-	p-s---ng-,p-s---mg-,d--------
νιν	p-s---ma-	p3s---ma-,p3s---fa-,p3s---na-
μῆνας	n-s---mg-	v2saia---,n-p---ma-
ἄλλοις	a-p---md-	p-p---nd-,p-p---md-
τοιαύτην	a-s---fa-	p-s---fa-
τὴν	p-s---fa-	l-s---fa-
κἀμὲ	p-s---fa-	a-s---mv-,p1s---ma-,p1s---fa-,a-s---mv-,a-s---mv-
αὐτὸς	a-s---mn-	p-s---mn-
ἀρτίπους	n-s---mn-	a-s---mn-,a-s---fn-,a-s---mv-,a-s---fv-
σοι	p-s---md-	p2s----d-
σὲ	p-s---ma-	a-s---mv-,p2s----a-,p2s----a-
χρεών	n-s---nn-	x--------
Εὐβοΐδα	a-s---fa-	n-s---fa-
αὐτὸν	a-s---ma-	p-s---ma-
τοῦτον	a-s---ma-	p-s---ma-
κἂν	g--------	c--------
ξυνήθης	a-s---mn-	v2siia---,v2siia---
ἡμᾶς	p-p---ma-	p1p---ma-,p1p---fa-,a-s---fg-
οὐδὲν	a-s---na-	p-s---nn-,p-s---nv-,p-s---na-
αὐλῶνος	n-s---fg-	n-s---mg-
ἀλλά	c--------	d--------
σφε	p-s---ma-	p-p---ma-,p-p---fa-
τῷ	p-s---md-	l-s---md-,l-s---nd-,x-s----d-,p-s----d-,d--------
αὑτοῦ	a-s---ng-	p-s---ng-,p-s---mg-
εἰσίδοιτο	v3saim---	v3saom---
ἁμοὶ	p-s---fd-	a-p---mn-,a-p---mv-
ὅ	l-s---na-	l-s---mn-,p-s---nn-,p-s---nv-,p-s---na-
διαιρετὸν	a-s---fa-	a-s---ma-,a-s---nn-,a-s---nv-,a-s---na-
ἐμὲ	p-s---fa-	p1s---ma-,p1s---fa-,a-s---mv-
πρῶτος	a-s---mns	a-s---mn-,a-s---mn-
σε	p-s---fa-	p2s----a-
ταῦτα	a-p---na-	p-p---nn-,p-p---nv-,p-p---na-
ἐκεῖνος	a-s---mn-	p-s---mn-
ἡμῖν	p-p---md-	p1p---md-,p1p---fd-
ἀλλὰ	c--------	d--------
εἴσω	r--------	v1sasa---,d--------
ἐκτὸς	r--------	d--------
ἀρσένων	a-p---mg-	n-p----g-
Ἀπόλλω	n-s---ma-	n-s---mn-,v3siia---
πρῶτα	a-p---nas	a-p---nn-,a-p---nv-,a-p---na-,a-p---nn-,a-p---nv-,a-p---na-
ἔγωγέ	p-s---mn-	p1s---mn-,p1s---fn-,p1s---mv-,p1s---fv-
Εὐβοιίς	a-s---fn-	n-s---fn-
Κηναίῳ	a-s---md-	n-s---nd-,n-s---md-
αὗται	a-p---fn-	p-p---fn-,p-p---fv-
τίνες	p-s---mg-	v2spia---,v2spia---,v2siia---,x-p---mn-,x-p---fn-,x-p---mv-,x-p---fv-,p-p---mn-,p-p---fn-,p-p---mv-,p-p---fv-
ταύτας	a-p---fa-	p-p---fa-,p-s---fg-
αὑτῷ	a-s---md-	p-s---nd-,p-s---md-
ταύτῃ	a-s---fd-	p-s---fd-,d--------
αὐτός	a-s---mn-	p-s---mn-
αὐτόν	a-s---ma-	p-s---ma-
αὐτοὶ	a-p---mn-	p-p---mn-,p-p---mv-
σέ	p-s---fa-	a-s---mv-,p2s----a-,p2s----a-
ἐκεῖνον	a-s---ma-	p-s---ma-
ἥδιστον	a-s---nns	a-s---ma-,a-s---nn-,a-s---nv-,a-s---na-
εἰσίδοιμί	v1saom---	v1saoa---
τίνος	p-s---mg-	x-s----g-,p-s----g-
ἐγώ	p-s---mn-	p1s---mn-,p1s---fn-,p1s---mv-,p1s---fv-
ὑστάτοις	a-s---mds	a-p---md-,a-p---nd-,a-p---md-,a-p---nd-
του	p-s---mg-	p-s----g-
ἡμὶν	p-p---fd-	p1p---md-,p1p---fd-
αὐτῇ	a-s---fd-	p-s---fd-
ἄλλην	a-s---fa-	p-s---fa-
ἐμοῦ	p-s---fg-	p1s---mg-,p1s---fg-,v2spme---,v2siie---,a-s---mg-,a-s---ng-
σύ	p-s---mn-	p2s----n-
οἷ	d--------	p-s---md-,p-s---fd-,l-p---mn-,l-p---mv-
πρῶτον	a-s---nas	a-s---ma-,a-s---nn-,a-s---nv-,a-s---na-,a-s---ma-,a-s---nn-,a-s---nv-,a-s---na-
τούτων	a-p---ng-	p-p---mg-,p-p---fg-,p-p---ng-
ἐκείνους	a-p---ma-	p-p---ma-,v2siia---
μοὶ	p-s---fd-	p1s---md-,p1s---fd-
σοὶ	p-s---fd-	v2spim---,a-p---mn-,a-p---mv-,p2s----d-,p2s----d-
τούτους	a-p---ma-	p-p---ma-
χὠ	l--------	l-s---mn-
τούτου	a-s---mg-	p-s---mg-,p-s---ng-
ταύτης	a-s---fg-	p-s---fg-
οὗτος	a-s---mn-	p-s---mn-,p-s---mv-
ἐμοί	p-s---md-	p1s---md-,p1s---fd-,a-p---mn-,a-p---mv-
αὐτῷ	a-s---md-	p-s---nd-,p-s---md-
σὺ	p-s---mn-	p2s----n-
τοῦτό	a-s---na-	p-s---nn-,p-s---nv-,p-s---na-
σου	p-s----g-	p2s----g-
οὐδέν	a-s---na-	p-s---nn-,p-s---nv-,p-s---na-
σέθεν	p-s---mg-	p2s----g-
πρίν	c--------	d--------
ταύτην	a-s---fa-	p-s---fa-
ταῦτά	a-p---na-	p-p---nn-,p-p---nv-,p-p---na-
ταὐτὸ	a-s---nn-	p-s---nn-,p-s---nv-,p-s---na-
αὐτήν	a-s---fa-	p-s---fa-
σώφρονος	a-s---mg-	a-s----g-
αὐτοῖς	a-p---nd-	p-p---nd-,p-p---md-
κἀμοῦ	p-s---fg-	a-s---mg-,a-s---ng-,d--------,v2siie---,v2spme---,p1s---mg-,p1s---fg-,v2spme---,a-s---mg-,a-s---ng-,a-s---mg-,a-s---ng-
μηδὲν	n-s---na-	p-s---nn-,p-s---nv-,p-s---na-
τινος	p-s---ng-	p-s----g-
αὑτὸν	a-s---ma-	p-s---ma-
κὴρ	n-s---mn-	n-s---fn-
αὐτῶν	a-p---fg-	p-p---ng-,p-p---fg-,p-p---mg-
αὐτῆς	a-s---fg-	p-s---fg-
ἄλλον	a-s---ma-	p-s---ma-
Οἰνιαδᾶν	n-p---mg-	n-p---fg-,n-p---fg-
ἱέμενοι	v-ppp-mn-	v-pppmmn-,v-pppmmv-
ἧστο	v3siie---	v3slim---
θατὴρ	n-s---fn-	n-s---mn-
ὑμᾶς	p-p---fa-	p2p----a-,a-s---fg-
ὑμῖν	p-p---fd-	p2p----d-
κἀμέ	p-s---fa-	a-s---mv-,p1s---ma-,p1s---fa-,a-s---mv-,a-s---mv-
τοσοῦτον	a-s---ma-	p-s---ma-
ὑστάτην	a-s---fas	a-s---fa-,a-s---fa-
τάς	p-p---fa-	l-p---fa-
ὑμῶν	p-p---fg-	p2p----g-,a-p---fg-,a-p---mg-,a-p---ng-
αὐτὰ	a-p---na-	p-p---nn-,p-p---nv-,p-p---na-,p-d---fn-,p-d---fv-,p-d---fa-,p-s---fn-,p-s---fv-
ἠγορῶ	v2siie---	v2siim---
ἐκείνῳ	a-s---md-	p-s---nd-,p-s---md-
μηδεὶς	n-s---m--	p-s---mn-,p-s---mv-
σοί	p-s---fd-	v2spim---,a-p---mn-,a-p---mv-,p2s----d-,p2s----d-
τά	p-p---nn-	l-p---na-,l-p---nn-,l-p---nv-,l-p---na-,l-d---fa-,l-d---fn-,l-d---fv-,l-d---fa-,x-p---nn-,x-p---nv-,x-p---na-
αὐτὴν	a-s---fa-	p-s---fa-
ἄλλο	a-s---na-	p-s---nn-,p-s---nv-,p-s---na-
σοῦται	v3spie---	v3spim---
ἀπόπτολιν	a-s---ma-	n-s---fa-,n-s---fa-
περαιτέρω	d--------	a-d---mn-,a-d---nn-,a-d---mv-,a-d---nv-,a-d---ma-,a-d---na-,a-s---mg-,a-s---ng-
τοιοῦτον	a-s---nn-	p-s---ma-
οὐδενὸς	a-s---ng-	p-s----g-
ἐμέ	p-s---fa-	p1s---ma-,p1s---fa-,a-s---mv-
τοιαῦτα	a-p---na-	p-p---nn-,p-p---nv-,p-p---na-
δέρκομαι	v1spie---	v1spim---
πίονος	a-s---ng-	n-s---mg-,n-s---fg-
μεθύστερον	a-s---nac	a-s---ma-,a-s---nn-,a-s---nv-,a-s---na-
πέπειρα	a-s---fn-	n-s---fn-,n-s---fv-,a-p---nn-,a-p---nv-,a-p---na-,a-p---nn-,a-p---nv-,a-p---na-
μηδέν	n-s---nn-	p-s---nn-,p-s---nv-,p-s---na-
τριῶν	m--------	m-p---mg-,m-p---fg-,m-p---ng-,v-sfpamn-,v-sfpamv-,v-sfpann-,v-sfpanv-,v-sfpana-,v-sfpamn-,v-sfpamv-,v-sfpann-,v-sfpanv-,v-sfpana-,v-sfpamn-
ἄλλου	a-s---mg-	p-s---ng-,p-s---mg-,d--------
Κήναιόν	a-s---nn-	n-s---nn-,n-s---nv-,n-s---na-,n-s---ma-
πιείρας	a-s---fg-	n-p---fa-,n-s---fg-
κἀκεῖνος	a-s---mn-	p-s---mn-
κοὐδεὶς	a-s---m--	p-s---mn-,p-s---mv-
ἑαυτόν	a-s---ma-	p-s---ma-
τάχιστα	a-p---nas	a-p---nn-,a-p---nv-,a-p---na-,a-p---nn-,a-p---nv-,a-p---na-
ἄριστον	a-s---mas	n-s---nn-,n-s---nv-,n-s---na-,n-s---nn-,n-s---nv-,n-s---na-,a-s---ma-,a-s---nn-,a-s---nv-,a-s---na-
αὐτὴ	a-s---fn-	p-s---fn-,p-s---fv-
τινὸς	p-s---mg-	p-s----g-
τίνι	p-s---md-	x-s----d-,p-s----d-
αὑτὴν	a-s---fa-	p-s---fa-
αὑτῆς	a-s---fg-	p-s---fg-
μᾶλλον	d-------c	d--------
ἑαυτὴν	a-s---fa-	p-s---fa-
κἀγὼ	p-s---fn-	n-d---mn-,n-d---mv-,n-d---ma-,p1s---mn-,p1s---fn-,p1s---mv-,p1s---fv-
τοσαῦτα	a-p---na-	p-p---nn-,p-p---nv-,p-p---na-
ἀμφιπλῆγι	a-s---nd-	n-s---md-,n-s---fd-
δυοῖν	m--------	m-d---mg-,m-d---fg-,m-d---ng-,m-d---md-,m-d---fd-,m-d---nd-
ἐκείνης	a-s---fg-	p-s---fg-
δύο	m--------	m-d---mn-,m-d---fn-,m-d---nn-,m-d---ma-,m-d---fa-,m-d---na-
ἔμοιγε	p-s---fd-	p1s---md-,p1s---fd-
πᾷ	p--------	n--------
τοῖσι	p-p---md-	l-p---md-,l-p---nd-,x-p----d-
ὕστατον	a-s---mas	a-s---ma-,a-s---nn-,a-s---nv-,a-s---na-,a-s---ma-,a-s---nn-,a-s---nv-,a-s---na-
μου	p-s---mg-	p1s---mg-,p1s---fg-
ἔγωγε	p-s---mn-	p1s---mn-,p1s---fn-,p1s---mv-,p1s---fv-
θῆλυς	a-s---fn-	a-s---mn-
τοιούτου	a-s---mg-	p-s---mg-
δέξαι	v2sam----	v2samm---,v2samm---,v--ana---,v3saoa---
ἐξωρμήκεν	v3sria---	v--rna---,v--rna---
χέρες	n-p---fv-	n-p---fn-
ὑμεῖς	p-p---mn-	p2p----n-
ἄλλων	a-p---mg-	p-p---ng-,p-p---fg-,p-p---mg-
ἀρίστης	a-s---fgs	a-s---fg-,v2siia---,v2siia---,v2siia---,v2spia---,v2siia---
Ἑλλάς	n-s---fv-	n-s---fn-,n-p---fa-
τοσοῦτος	a-s---mn-	p-s---mn-
μηδενὸς	p-s---mn-	p-s----g-
τούτοισι	a-p---nd-	p-p---md-,p-p---nd-
κοὐδὲν	a-s---nn-	p-s---nn-,p-s---nv-,p-s---na-
τἄλλα	a-p---na-	p-p---nn-,p-p---nv-,p-p---na-,p-d---fn-,p-d---fv-,p-d---fa-,p-s---fn-,p-s---fv-
ἄλλα	a-p---na-	p-p---nn-,p-p---nv-,p-p---na-,p-d---fn-,p-d---fv-,p-d---fa-,p-s---fn-,p-s---fv-
ἄλλος	a-s---mn-	p-s---mn-
αὕτη	a-s---fn-	p-s---fn-,p-s---fv-
χάλυβος	n-s---mg-	n-s---mn-
ἐκείνοις	a-p---md-	p-p---nd-,p-p---md-
ἡγουμένου	v-sppemg-	v-sppmmg-,v-sppmng-
Ἀθήνησι	d--------	n-p---md-
Ῥωμαῖοι	n-p---mn-	a-p---mn-,a-p---mv-
Ἠλείοις	n-p---md-	a-p---md-,a-p---nd-
ἑβδομήκοντα	a--------	m--------
διόπερ	d--------	c--------
Καρχηδονίους	n-p---ma-	a-p---ma-,a-p---ma-
Καρχηδόνιοι	n-p---mn-	a-p---mn-,a-p---mv-,a-p---mn-,a-p---mv-
Λιγυστικῆς	n-s---fg-	a-s---fg-,a-s---fg-
τριάκοντα	a--------	m--------
Καρχηδονίων	n-p---mg-	a-p---fg-,a-p---mg-,a-p---ng-,a-p---fg-,a-p---mg-,a-p---ng-
παραθαλάττιον	a-s---fa-	a-s---ma-,a-s---nn-,a-s---nv-,a-s---na-
Κιλικίαν	n-s---fa-	a-s---fa-,a-s---fa-
Καρίαν	n-s---fa-	a-s---fa-
Καρχηδονίοις	n-p---md-	a-p---md-,a-p---nd-,a-p---md-,a-p---nd-
καθότι	c--------	d--------
Λακεδαιμονίων	n-p---mg-	a-p---fg-,a-p---mg-,a-p---ng-
βαρβάρων	n-p---mg-	a-p---mg-,a-p---fg-,a-p---ng-,v3piia---,v1siia---,v3piia---,v1siia---
βαρβάρους	n-p---ma-	a-p---ma-,a-p---fa-,v2siia---,v2siia---
πρέσβεις	n-p---ma-	n-p---fn-,n-p---fv-,n-p---fn-,n-p---fa-,n-p---mn-,n-p---mv-
ἡγοῦνται	v3ppie---	v3ppim---
τηλικαύτην	a-s---fa-	p-s---fa-
πρέσβεων	n-p---mg-	n-p---fg-
ὀγδοήκοντα	a--------	m--------
εἴκοσι	a--------	m--------
Αἰγύπτιοι	n-p---mn-	a-p---mn-,a-p---mv-
τετταράκοντα	a--------	m--------
Κύπριοι	n-p---mn-	a-p---mn-,a-p---mv-,a-p---mn-,a-p---mv-
πεντήκοντα	a--------	m--------
Καρίᾳ	n-s---fd-	a-s---fd-
Κῴων	n-p---mg-	n-p---ng-,a-p---fg-,a-p---mg-,a-p---ng-,a-p---fg-,a-p---mg-,a-p---ng-
ἑκατόν	a--------	m--------
Λεσβίων	n-p---mg-	a-p---fg-,a-p---mg-,a-p---ng-,a-p---fg-,a-p---mg-,a-p---ng-
Τενεδίων	n-p---mg-	a-p---fg-,a-p---mg-,a-p---ng-
Ἑλλησπόντιοι	n-p---mn-	a-p---mn-,a-p---mv-,a-p---mn-,a-p---mv-
ἐντὸς	r--------	d--------
τινα	a-s---fa-	p-s---ma-,p-s---fa-,p-p---nn-,p-p---nv-,p-p---na-
Λακεδαιμόνιοι	n-p---mn-	a-p---mn-,a-p---mv-
Θηβαίων	n-p---mg-	a-p---fg-,a-p---mg-,a-p---ng-
μέγισται	a-p---fns	a-p---fn-,a-p---fv-
τίνα	a-s---fa-	x-s---ma-,x-s---fa-,x-p---nn-,x-p---nv-,x-p---na-,p-s---ma-,p-s---fa-,p-p---nn-,p-p---nv-,p-p---na-
τηλικαύτας	a-p---fa-	p-p---fa-,p-s---fg-
Λακεδαιμονίους	n-p---ma-	a-p---ma-
Κίσσιοι	n-p---mn-	a-p---mn-,a-p---mv-
βάρβαροι	n-p---mn-	a-p---mn-,a-p---fn-,a-p---mv-,a-p---fv-
βαρβάροις	n-p---md-	a-p---md-,a-p---fd-,a-p---nd-
ἐκθύμως	a--------	d--------,a-p---ma-,a-p---fa-
πρεσβύτεροι	a-p---mnc	a-p---mn-,a-p---mv-
πρεσβυτέρων	a-p---mgc	a-p---fg-,a-p---mg-,a-p---ng-
τούτῳ	a-s---md-	p-s---md-,p-s---nd-
ἄλλους	a-p---ma-	p-p---ma-
ἄλλας	a-p---fa-	p-p---fa-,p-s---fg-
ἡγουμένους	v-pppema-	v-pppmma-
ἡγούμενον	v-sppema-	v-sppmma-,v-sppmnn-,v-sppmnv-,v-sppmna-
διὸ	d--------	c--------
τοιγαροῦν	d--------	g--------
καλλίστας	a-p---fas	a-p---fa-,a-s---fg-
τοσούτων	a-p---fg-	p-p---ng-,p-p---mg-
μεγίστους	a-p---mas	a-p---ma-
τοιούτων	a-p---mg-	p-p---mg-
ἐγκώμιον	n-s---na-	a-s---ma-,a-s---fa-,a-s---nn-,a-s---nv-,a-s---na-
ἐντάφιον	n-s---na-	a-s---ma-,a-s---fa-,a-s---nn-,a-s---nv-,a-s---na-
Σιδωνίους	n-p---ma-	a-p---ma-
Ἀθηναῖοι	n-p---mn-	a-p---mn-,a-p---mv-
ἀπόπλουν	n-s---ma-	a-s---ma-,v3piia---,v1siia---,v3piia---,v1siia---
τινὶ	a-s---fd-	p-s----d-
Πλαταιὰς	n-p---fa-	a-p---fa-
Ἀττικὴν	n-s---fa-	a-s---fa-
Ἀττικήν	n-s---fa-	a-s---fa-
Ἀττικῆς	n-s---fg-	a-s---fg-
Κερκυραῖοι	n-p---mn-	a-p---mn-,a-p---mv-
ἑξήκοντα	a--------	m--------
Μαλέαν	n-s---ma-	n-s---fa-
μεταξὺ	r--------	d--------
Ἡρακλείου	n-s---ng-	a-s---mg-,a-s---ng-,a-s---mg-,a-s---fg-,a-s---ng-
Φοινισσῶν	n-p---mg-	n-p---fg-,n-p---fg-,v-sfpamn-
Κυπρίων	n-p---mg-	n-p---ng-,a-p---fg-,a-p---mg-,a-p---ng-,n-p---ng-,a-p---fg-,a-p---mg-,a-p---ng-
Κυπρίους	n-p---ma-	a-p---ma-,a-p---ma-
τοσαύτας	a-p---fa-	p-p---fa-,p-s---fg-
τοιῷδέ	a-s---md-	p-s---md-,p-s---nd-
τινι	a-s---md-	p-s----d-
δυσὶ	a-p---nd-	m-p---md-,m-p---fd-,m-p---nd-
μήποτε	c--------	d--------
τρεῖς	a-p---fa-	v2spia---,v2siia---,m-p---mn-,m-p---fn-,m-p---mv-,m-p---fv-,m-p---ma-,m-p---fa-
Ἱμεραίων	n-p---mg-	a-p---fg-,a-p---mg-,a-p---ng-,a-p---fg-,a-p---mg-,a-p---ng-
Ἀκραγαντίνων	n-p---mg-	a-p---fg-,a-p---mg-,a-p---ng-
τοσούτους	a-p---ma-	p-p---ma-
πλειόνων	a-p---mgc	a-p----gc,a-p---ngc
τοιαύτης	a-s---fg-	p-s---fg-
Σελινουντίων	n-p---mg-	a-p---fg-,a-p---mg-,a-p---ng-
τινων	p-p---mg-	p-p----g-
πεντεκαίδεκα	a--------	m--------
τοιούτῳ	a-s---nd-	p-s---md-,p-s---nd-
μηδὲ	d--------	g--------
Συρακοσίοις	n-p---md-	a-p---md-,a-p---nd-
Ἀκραγαντῖνοι	n-p---mn-	a-p---mn-,a-p---mv-
μεσόγειον	a-s---fa-	a-s---ma-,a-s---nn-,a-s---nv-,a-s---na-
καίπερ	d--------	g--------
ἑπτά	a--------	m--------,n-s---fv-
Συρακοσίους	n-p---ma-	a-p---ma-
ἑκκαίδεκα	a--------	m--------
Λακεδαιμονίοις	n-p---md-	a-p---md-,a-p---nd-
διπλασίοσι	a-p---fd-	a-p----d-
τοιαύτη	a-s---fn-	p-s---fn-,p-s---fv-
τηλικαύτης	a-s---fg-	p-s---fg-
ἱερὰ	n-p---na-	n-d---fn-,n-d---fv-,n-d---fa-,n-s---fn-,n-s---fv-,a-p---nn-,a-p---nv-,a-p---na-,a-d---fn-,a-d---fv-,a-d---fa-,a-s---fn-,a-s---fv-,a-p---nn-,a-p---nv-,a-p---na-
Πλαταιαῖς	n-p---fd-	a-p---fd-
Κορίνθιοι	n-p---mn-	a-p---mn-,a-p---mv-
Σικυώνιοι	n-p---mn-	a-p---mn-,a-p---mv-,a-p---mn-,a-p---mv-
Φλιάσιοι	n-p---mn-	a-p---mn-,a-p---mv-,a-p---mn-,a-p---mv-
Θηβαῖοι	n-p---mn-	a-p---mn-,a-p---mv-
μήν	d--------	n-s---mn-,n-s---mv-,g--------,n-s---ma-
ὑπείκειν	v--pna---	v1slia---,v--rna---
ἡγούμενοι	v-pppemn-	v-pppmmn-,v-pppmmv-
ὀξυτάταις	a-p---fds	a-p---fd-
ἐγκώμια	n-p---na-	a-p---nn-,a-p---nv-,a-p---na-
κηρύξαι	v3sana---	v3saoa---
Πλαταιάς	n-p---fa-	a-p---fa-
θρασυτέρους	a-p---mac	a-p---ma-
φίλοις	n-p---md-	a-p---md-,a-p---nd-
Μιλησίων	n-p---mg-	a-p---fg-,a-p---mg-,a-p---ng-
ἐννέα	a--------	m--------
Συρακοσίων	n-p---mg-	a-p---fg-,a-p---mg-,a-p---ng-
πρεσβυτάτῳ	a-s---mds	a-s---md-,a-s---nd-
Ἐννέα	a--------	n-d---fn-,n-d---fv-,n-d---fa-,n-s---fn-,n-s---fv-,m--------
ἕνδεκα	a--------	m--------
ὀκτώ	a--------	m--------
μειζόνων	a-p---fgc	a-p----gc
Ῥωμαίοις	n-p---md-	a-p---md-,a-p---nd-,a-p---md-,a-p---nd-
μείζοσιν	a-p---fdc	a-p----dc
ἄλλαις	a-p---fd-	p-p---fd-
μέγιστον	a-s---mas	a-s---ma-,a-s---nn-,a-s---nv-,a-s---na-
μέγιστα	a-p---nas	a-p---nn-,a-p---nv-,a-p---na-
τοῦδὲ	a-s---mg-	p-s---mg-,p-s---ng-
τινὰ	a-s---fa-	p-s---ma-,p-s---fa-,p-p---nn-,p-p---nv-,p-p---na-
τηλικαύταις	a-p---fd-	p-p---fd-
τοιαύταις	a-p---fd-	p-p---fd-
καθάπερ	c--------	d--------
ἀμβλυτέρους	a-p---mac	a-p---ma-
μεγίστην	a-s---fas	a-s---fa-
Σκαμάνδριος	n-s---mn-	a-s---mn-,a-s---fn-
Ἱμεραίους	n-p---ma-	a-p---ma-,a-p---ma-
Ναξίους	n-p---ma-	a-p---ma-
Καταναίους	n-p---ma-	a-p---ma-
Καταναίαν	n-s---fa-	a-s---fa-
δυεῖν	a-p---fg-	v--pna---
Τυρρηνῶν	n-p---mg-	a-p---fg-,a-p---mg-,a-p---ng-,a-p---fg-,a-p---mg-,a-p---ng-
Τυρρηνούς	n-p---ma-	a-p---ma-,a-p---ma-
Τυρρηνοὺς	n-p---ma-	a-p---ma-,a-p---ma-
Κυμαίους	n-p---ma-	a-p---ma-
ἕξ	a--------	m--------
Συρακόσιοι	n-p---mn-	a-p---mn-,a-p---mv-
Ῥωμαίων	n-p---mg-	a-p---fg-,a-p---mg-,a-p---ng-,a-p---fg-,a-p---mg-,a-p---ng-
Ἠλεῖοι	n-p---mn-	a-p---mn-,a-p---mv-
Μολοττῶν	n-p---mg-	a-p---mg-,a-p---fg-,a-p---ng-
τοιαύτας	a-s---fg-	p-p---fa-,p-s---fg-
εὔιχθυν	a-s---fa-	a-s---ma-
μεγίστου	a-s---mgs	a-s---mg-,a-s---ng-
τοιούτοις	a-p---nd-	p-p---md-,p-p---nd-
Ποπλικόλαν	n-s---ma-	n-s---fa-
Κιλικίας	n-s---fg-	a-p---fa-,a-s---fg-,a-p---fa-,a-s---fg-
τηλικαύτῃ	a-s---fd-	p-s---fd-
φίλους	n-p---ma-	a-p---ma-,n-s---ng-,v2siia---
Πισίδας	n-s---ma-	a-p---fa-,a-s---fg-
τοιαῦται	a-p---fn-	p-p---fn-,p-p---fv-
τηλικαῦται	a-p---fn-	p-p---fn-,p-p---fv-
τηλικούτοις	a-p---nd-	p-p---nd-,p-p---md-
ἐπέχει	v3saia---	v3siia---,v2spie---,v3spia---
Μεσσηνίας	n-s---fg-	a-p---fa-,a-s---fg-
Ἀργείοις	n-p---md-	a-p---md-,a-p---nd-
Μυκηναίοις	n-p---md-	a-p---md-,a-p---nd-
Μυκηναῖοι	n-p---mn-	a-p---mn-,a-p---mv-
Ἀργείαν	n-s---fa-	a-s---fa-
Μυκηναίους	n-p---ma-	a-p---ma-
Καπιτώλιον	n-s---nn-	n-s---ma-
πρεσβύτατος	a-s---mns	a-s---mn-
ἡγησομένους	v-p-pmma-	v-ptpema-,v-pfpmma-,v-ptpmma-
μεσογείῳ	a-s---fd-	a-s---md-,a-s---nd-
Θάσιοι	n-p---mn-	a-p---mn-,a-p---mv-
Αἰγυπτίους	n-p---ma-	a-p---ma-,v2siia---
Αἰγυπτίοις	n-p---md-	a-p---md-,a-p---nd-
ἄλλης	a-s---fg-	p-s---fg-
Κυπρίοις	n-p---md-	n-p---nd-,a-p---md-,a-p---nd-,n-p---nd-,a-p---md-,a-p---nd-
πλείοσι	a-p---fdc	a-p----dc,a-p---ndc
Γελῷοι	n-p---mn-	a-p---mn-,a-p---mv-
Ἱμεραῖοι	n-p---mn-	a-p---mn-,a-p---mv-
Μεσσηνίᾳ	n-s---fd-	a-s---fd-
ἀπαλλοτρίους	a-p---fa-	a-p---ma-,v2siia---,v2siia---,v2siia---,v2siia---
νόμιμα	n-p---na-	a-p---nn-,a-p---nv-,a-p---na-
Κορινθίοις	n-p---md-	a-p---md-,a-p---nd-
Ἐπιδαυρίοις	n-p---md-	a-p---md-,a-p---nd-
Ἄλβας	n-s---mn-	n-p---fa-,n-s---fg-
Κορινθίους	n-p---ma-	a-p---ma-
Κορινθίων	n-p---mg-	a-p---fg-,a-p---mg-,a-p---ng-
τοσαύτης	a-s---fg-	p-s---fg-
Ἀργείους	n-p---ma-	a-p---ma-
τετραμηνιαίους	a-p---fa-	a-p---ma-
Θηβαίοις	n-p---md-	a-p---md-,a-p---nd-
περίβολον	n-s---ma-	a-s---ma-,a-s---fa-,a-s---nn-,a-s---nv-,a-s---na-
Παρνασίαν	n-s---fa-	a-s---fa-
Φαρσαλίων	n-p---mg-	a-p---fg-,a-p---mg-,a-p---ng-
Φαρσάλιοι	n-p---mn-	a-p---mn-,a-p---mv-
Κυρηναῖος	n-s---mn-	a-s---mn-
Ἐγεσταίοις	n-p---md-	a-p---md-,a-p---nd-
χαριέστατοι	a-p---mns	a-p---mn-,a-p---mv-
μεγίστων	a-p---mgs	a-p---fg-,a-p---mg-,a-p---ng-
Σικυωνίων	n-p---mg-	a-p---fg-,a-p---mg-,a-p---ng-,a-p---ng-,a-p---fg-,a-p---mg-,a-p---ng-
Ναξίων	n-p---mg-	a-p---fg-,a-p---mg-,a-p---ng-,v-sfpamn-
ἀγνώμοσι	a-p---md-	a-p----d-
ὀκτὼ	a--------	m--------
Συβάριος	n-s---mg-	n-s---fg-
Κράθιος	n-s---mg-	n-s---fg-
Πελοπιδῶν	a-p---mg-	n-p---mg-
φίλτατε	a-s---mvs	a-s---mv-
ἐμέν	v1ppia---	v--pna---
καὐτὸς	a-s---mn-	p-s---mn-
μέγιστος	a-s---mns	a-s---mn-
μοί	p-s---fd-	p1s---md-,p1s---fd-
πελέκει	n-s---md-	n-d---fn-,n-d---fv-,n-d---fa-,n-s---fd-,v2spma---,v3siia---
μοῦ	p-s---fg-	p1s---mg-,p1s---fg-,n-s---mg-
ἠχὼ	n-s---fa-	n-s---fn-
ἐφίει	v2spie---	v2spma---,v2spma---,v3siia---,v3siia---
εὔφρονι	a-s---md-	a-s----d-
οὔτις	a-s---mn-	p-s---mn-,p-s---fn-
ἐχθίστα	a-s---fns	a-d---fn-,a-d---fv-,a-d---fa-,a-s---fn-,a-s---fv-
ἁγὼ	p-s---fn-	n-d---mn-,n-d---mv-,n-d---ma-,p1s---mn-,p1s---fn-,p1s---mv-,p1s---fv-
χρεὼν	n-s---nn-	x--------
ἐκείνην	a-s---fa-	p-s---fa-
αὑτήν	a-s---fa-	p-s---fa-
τοσοῦτόν	a-s---ma-	p-s---ma-
τοὐμὲ	p-s---fa-	p1s---ma-,p1s---fa-,a-s---mv-
αὐτή	a-s---fn-	p-s---fn-,p-s---fv-
τοιαῦτά	a-p---na-	p-p---nn-,p-p---nv-,p-p---na-
ἆρα	d--------	n--------,v1saia---
κἀκείνῳ	a-s---md-	p-s---nd-,p-s---md-
φιλτάτῳ	a-s---mds	a-s---md-,a-s---nd-
πολύπους	n-s---fn-	n-p---ma-,a-s---mn-,a-s---fn-,a-s---mv-,a-s---fv-
χαλκόπους	n-s---fn-	a-s---mn-,a-s---fn-,a-s---mv-,a-s---fv-
τίνων	p-p---mg-	v-sppamn-,v-sppamn-,x-p----g-,p-p----g-
αὐτοῖσι	a-p---md-	p-p---nd-,p-p---md-
ἄλλη	a-s---fn-	p-s---fn-,p-s---fv-
σαυτῇ	p-s---fg-	p-s---fd-,p-s---fd-
ἴδρις	a-s---fn-	n-p----a-,n-s----n-
τηλικοῦτος	a-s---fn-	p-s---mn-,p-s---fn-,p-s---mn-
ἆρά	d--------	n--------,v1saia---
ἡδεῖς	a-p---ma-	a-p---mn-
ὠκύπους	n-s---mn-	a-p---ma-,a-p---fa-,a-p---ma-,a-p---fa-,a-s---mn-,a-s---fn-,a-s---mv-,a-s---fv-
Αἰνιὰν	a-s---nn-	n-s---mn-,n-s---mv-
Αἰνιᾶνος	a-s---mg-	n-s---mg-
Βαρκαίοις	a-p---md-	n-p---md-,n-p---md-
ὤτων	n-p---ng-	a-p---mg-,a-p---fg-,a-p---ng-,a-p---mg-,a-p---fg-,a-p---ng-
ὑμὶν	p-p---fd-	p2p----d-
Ἀμφιάρεων	n-s---ma-	n-s---fa-
μέ	p-s---fa-	p1s---ma-,p1s---fa-
ἡμίν	p-p---md-	p1p---md-,p1p---fd-
νῷν	p-d---fd-	p1d---mg-,p1d---fg-,p1d---md-,p1d---fd-
ἐδερκόμην	v1siie---	v1siim---
ἆσσον	r--------	d-------c
σύνηθες	a-s---nn-	v2siia---
αὐτοῖσί	a-p---md-	p-p---nd-,p-p---md-
αὑτὸς	a-s---mn-	p-s---mn-
καλῶν	a-p---ng-	n-p---fg-,v-sfpamn-,v-sppamn-,n-p---fg-
τἀκείνου	a-s---mg-	p-s---ng-,p-s---mg-,v3siia---
ἃν	p-p---na-	p-s---fa-
κἀμοὶ	p-s---fd-	a-p---mn-,a-p---mv-,v2spse---,v2spie---,v3spsa---,p1s---md-,p1s---fd-,a-p---mn-,a-p---mv-,a-p---mn-,a-p---mv-
τώδε	p-d---fa-	p-d---ma-,p-d---na-,p-d---mn-,p-d---nn-,p-d---mv-,p-d---nv-
κασιγνήτω	n-d---fa-	n-d---mn-,n-d---mv-,n-d---ma-,n-s---mg-
ὣ	p-d---fn-	p-d---ma-,p-d---na-,p-d---mn-
ἀφειδήσαντε	v-dapafn-	v-dapamn-,v-dapann-,v-dapamv-,v-dapanv-,v-dapama-,v-dapana-
τούτω	a-d---fa-	p-s---mg-,p-s---ng-,p-d---ma-
σαυτήν	p-s---fg-	p-s---fa-,p-s---fa-
πράσσοντε	v-dppafn-	v-dppamn-,v-dppann-,v-dppamv-,v-dppanv-,v-dppama-,v-dppana-
λαβόντε	v-dapafn-	v-dapamn-,v-dapann-,v-dapamv-,v-dapanv-,v-dapama-,v-dapana-
ζῴης	v2spoa---	n-s---fg-
ἄριστα	a-p---nas	n-p---nn-,n-p---nv-,n-p---na-,n-p---nn-,n-p---nv-,n-p---na-,a-p---nn-,a-p---nv-,a-p---na-
κοινόπουν	n-s---fa-	a-s---ma-,a-s---fa-
τοὐκείνου	a-s---mg-	p-s---ng-,p-s---mg-,v3siia---
Ἠλέκτρας	n-s---fv-	n-s---fg-
ἐκεῖνο	a-s---nn-	p-s---nn-,p-s---nv-,p-s---na-
μὲ	p-s---fa-	p1s---ma-,p1s---fa-
ἄδμητον	a-s---fa-	a-s---ma-,a-s---nn-,a-s---nv-,a-s---na-
κἀγώ	p-s---mn-	n-d---mn-,n-d---mv-,n-d---ma-,p1s---mn-,p1s---fn-,p1s---mv-,p1s---fv-
φιλτάταν	a-----fas	a-s---fa-
ἄλλοισι	a-p---md-	p-p---nd-,p-p---md-
προυφάνης	v2saip---	v2siia---,v2siia---,v2siia---,v2spia---,v2siia---
αὐτό	a-s---na-	p-s---nn-,p-s---nv-,p-s---na-
αὐτοῖσιν	a-p---nd-	p-p---nd-,p-p---md-
τούτοισιν	a-p---nd-	p-p---md-,p-p---nd-
οὗτός	a-s---mn-	p-s---mn-,p-s---mv-
πλείοσιν	a-p---md-	a-p----dc,a-p---ndc
χεῖρες	n-p---fv-	n-p---fn-
σφῷν	p-d---md-	p-p---mg-,p-p---fg-,p2d----g-,p2d----d-,p2d----g-,p2d----d-
αὐτοῖν	a-d---mg-	p-d---ng-,p-d---nd-,p-d---mg-,p-d---md-
δολιόπους	n-s---mn-	a-s---mn-,a-s---fn-,a-s---mv-,a-s---fv-
κρείσσοσιν	a-p---m-c	a-p----dc
αἰσθάνει	v2spie---	v2spim---
ἄριστος	a-s---mns	a-s---mn-
τῶν]	p-p---mg-	l-p---fg-,l-p---mg-,l-p---ng-
λαμπτὴρ	n-s---mv-	n-s---mn-
πιφαύσκων	v-sppamv-	v-sppamn-
φρυκτὸς	n-s---mn-	a-s---mn-
στρατιῶτιν	a-s---fa-	n-s---fa-
τρίποδας	n-p---ma-	a-p---ma-,a-p---fa-
ἀστυνόμων	a-p---mg-	n-p---mg-
καταπνεύει	v3spi----	v2spie---,v3spia---
ἀργᾶς	a-s---mn-	a-s---fg-,a-s---fg-
πομπούς	n-p---fa-	n-p---ma-
πτάκα	n-s---fa-	n-s---ma-
δρόσοισι	n-p---md-	n-p---fd-
ὁδώ	---------	n-d---mn-,n-d---mv-,n-d---ma-,n-d---fn-,n-d---fv-,n-d---fa-
ἡμένων	v-prpemg-	v-prpmfg-,v-prpmmg-,v-prpmng-
οὔτινα	a-s---ma-	p-s---ma-,p-s---fa-,p-p---nn-,p-p---nv-,p-p---na-
γένωμαι	v1sas----	v1sasm---
αἰσχρόμητις	a-s---fn-	n-s---mn-,n-s---fn-
πρωτοπήμων	a-s---fn-	n-s---mn-,n-s---fn-,n-s---mv-,n-s---fv-
τέκμαρ	n-s---nn-	x-s---nn-,x-s---nv-,x-s---na-
Μεσσαπίου	n-s---ng-	a-s---mg-,a-s---ng-
ἠναίνετο	v3siie---	v3siim---
ἀφίκετο	v3sai----	v3saim---,v3saim---
ἄλειφά	n-s---na-	n-s---nn-
τράπε	---------	v2sama---,v3saia---
ἀφημένων	v--pp-mg-	v-prpmfg-,v-prpmmg-,v-prpmng-
κά	n-s---fn-	g--------
κατεψάκαζον	v3siia---	v3piia---,v1siia---
ἀναίνομαι	v1spie---	v1spim---
δία	n-s---ma-	a-d---fn-,a-d---fv-,a-d---fa-,a-s---fn-,a-s---fv-
σπεύσω	v1sfia---	v1sasa---,v2saim---
δύσφροσιν	a-p---md-	a-p----d-
τοιῶνδε	p-p---ng-	p-p---fg-
ἀλλήλαισι	a-p---fd-	p-p---fd-
τυφῶ	n-s---mg-	v1sasp---,v1sasp---,v1spsa---,v1spia---,n-s---md-
κῆ	a-s---fa-	v2spma---,v3siia---,g--------,n--------
Σιμόεντος	a-s---mg-	n-s---mg-
κτὰς	n-p---fa-	v-sapamn-,v-sapamv-
ξυνεστίου	a-s---mg-	v2spme---,v2spme---,v2siie---,v2siie---
κικλήσκου	---------	v2spme---,v2siie---
οὕ	---------	p-s---ma-,p-s---fa-,p-s---ma-,p-s---fa-,i--------
εἰδομένας	v-pppefa-	v-pppmfa-,v-sppmfg-
εὔφρονος	a-s---fg-	a-s----g-
ὑπερθορὼν	v-papamn-	v-sapamn-
προσήμενος	v-sppemn-	v-srpmmn-
ἧσθαι	v--rn----	v--rnm---
ἡγῆται	v3spse---	v3spsm---,v3spim---
προσδέρκεται	v3spie---	v3spim---
τίπτε	d--------	n--------
παρή	---------	a-s---fn-,a-s---fv-
ὦρτο	v3sai----	v3saim---
πλέω	a-p---nac	a-p---nnc,a-d---mn-,a-d---nn-,a-d---mv-,a-d---nv-,a-d---ma-,a-d---na-,a-s---mg-,a-s---ng-,a-d---mn-,a-d---nn-,a-d---mv-,a-d---nv-,a-d---ma-,a-d---na-,a-s---mg-,a-s---ng-,v1spsa---,v1spia---
ἀπόλλων	n-s---mn-	v3piia---,v1siia---
οὔτινας	a-p---ma-	p-p---ma-,p-p---fa-
ἐκεῖνα	a-p---na-	p-p---nn-,p-p---nv-,p-p---na-
ἅτε	p-s---fn-	d--------
μελαγκέρῳ	a-s---nd-	a-p---mn-,a-p---fn-,a-p---mv-,a-p---fv-
αὑτᾶς	a-s---fg-	p-s---fg-
τίθη	---------	v2spma---,v3siia---,v3siia---
προσήμεναι	v-pppefn-	v--pna---,v-prpmfn-,v-prpmfv-
πρώταρχον	a-s---fa-	n-s---ma-,n-s---mv-
δυσφροιμίοις	a-p---nd-	n-p---nd-
ἐφημένους	v-ppp-ma-	v-prpmma-
ἄναλκιν	a-s---ma-	n-s---fa-
γένοιτό	v3sao----	v3saom---
δίπους	n-s---fn-	a-s---mn-,a-s---fn-,a-s---mv-,a-s---fv-
εὐδαιμόνων	a-p---mg-	a-p----g-
τοιοῦτός	a-s---mn-	p-s---mn-
ἡγουμένοις	v-pppemd-	v-pppmmd-,v-pppmnd-
πεπαιτέρα	a-s---fnc	a-d---fn-,a-d---fv-,a-d---fa-,a-s---fn-,a-s---fv-
τοσῶνδε	p-p---ng-	p-p---fg-
ἀφράσμονος	a-s---fg-	a-s----g-,a-s----g-
ἔσῃ	v2sfi----	v2sfim---,v2sasm---
περίφρονα	a-p---na-	n-s---ma-,n-s---fa-
τέλειον	a-s---fa-	a-s---ma-,a-s---nn-,a-s---nv-,a-s---na-,v3piia---,v1siia---
βαρύμηνιν	a-s---ma-	n-s---fa-
πονήσει	v3sfia---	n-d---fn-,n-d---fv-,n-d---fa-,n-s---fd-,n-s---fd-,v2sfie---,v3sasa---,v2sfie---
Πλεισθενιδῶν	a-p---mg-	n-p---mg-
θεμένη	v-sap-fn-	v-sapmfn-,v-sapmfv-
ἀπόχρη	v3spia---	v3siia---,v2spma---,v3siia---,v2spma---,v3siia---
καθήμενος	v-srp-mn-	v-srpmmn-
Πελοπίδαις	a-p---md-	n-p---md-
ξυνδίκως	d--------	n-p---ma-,n-p---fa-
τηλικούτῳ	a-s---md-	p-s---nd-,p-s---md-
χωρῇ	n-s---fd-	v2sfim---,v3sfia---,v2spse---,v2spie---,v3spsa---
νέα	n-s---ma-	n-s---fa-,n-d---fn-,n-d---fv-,n-d---fa-,n-s---fn-,n-s---fv-,a-p---nn-,a-p---nv-,a-p---na-,a-d---fn-,a-d---fv-,a-d---fa-,a-s---fn-,a-s---fv-,a-p---nn-,a-p---nv-,a-p---na-,v2spma---,v3siia---
Μηδείην	n-s---fa-	a-s---fa-
Ἰοῦς	n-s---fg-	n-p---fv-,v2spia---
ὦν	d--------	g--------
σωφρόνων	a-p---mg-	a-p----g-
κεχωρίσθαι	v--rnp---	v--rne---
νεός	n-s---mg-	n-s---fg-
ἐρέων		n-p---fg-,n-p---ng-,v-sppamn-,v-sppamn-,v-sfpamn-
κως	d--------	g--------
ἄστεα	n-p---nd-	n-p---nn-,n-p---nv-,n-p---na-
ἐμεῦ	p-s---mg-	p1s---mg-,p1s---fg-,v2spme---,v2siie---
Συρίων	n-p---mg-	a-p---fg-,a-p---mg-,a-p---ng-,v-sfpamn-
Σαρδίων	n-p---mg-	n-p---fg-,n-p---ng-
σέο	p-s---mg-	v2spme---,v2siie---,p2s----g-,p2s----g-
τὶ	a-s---nn-	x-s---nn-,x-s---nv-,x-s---na-,p-s---nn-,p-s---nv-,p-s---na-
μηδέ	d--------	g--------
σεῦ	p-s---mg-	v2spme---,v2siie---,p2s----g-
κοίτην	n-s---ma-	v3dpoa---,n-s---fa-
ἐπορᾷ	v3siia---	v2spsm---,v2spim---,v2spse---,v2spie---,v3spsa---,v3spia---
νοῶ	n-s---md-	v1spsa---,v1spia---,v1spsa---,v1spia---
δυῶν	a-p---fg-	n-p---fg-,m-p---mg-,m-p---fg-,m-p---ng-,m-p---md-,m-p---fd-,m-p---nd-,v-sppamv-,v-sppann-,v-sppanv-,v-sppana-,v-sppamn-,v-sppamn-
οὐδέ	c--------	g--------,n-s---mv-,n-s---fv-
Ἄρδυος	n-s---mg-	n-s---fg-
ἠθέων	n-p---fg-	n-p---ng-,v-sppamn-
δυώδεκα	a--------	x--------,m--------
Μιλησίοισι	n-p---md-	a-p---md-,a-p---nd-
γυναικηίου	a-s---fg-	a-s---mg-,a-s---ng-
ἀνδρηίου	a-s---fg-	a-s---mg-,a-s---ng-,n-s---ng-
Μιλησίην	n-s---fa-	a-s---fa-
Μιλήσιοι	n-p---mn-	a-p---mn-,a-p---mv-
δεδήλωται	v3srip---	v3srie---
συνεπελάφρυνον	v3siia---	v2sama---,v2sama---,v3piia---,v1siia---,v3piia---,v1siia---
Χῖοι	n-p---mn-	a-p---mn-,a-p---mv-
Χίοισι	n-p---md-	n-p---fd-,a-p---md-,a-p---nd-,v-pppamd-,v-pppand-,n-p---nd-
τευ	p-s---mg-	p2s----g-,p-s----g-
Μιλησίους	n-p---ma-	a-p---ma-
Λέσβιοι	n-p---mn-	a-p---mn-,a-p---mv-,a-p---mn-,a-p---mv-
Κορινθίοισι	n-p---md-	a-p---md-,a-p---nd-
ἀπηγέεσθαι	v--pne---	v--pnm---
φαμένων	v-pppemg-	v-pppmfg-,v-pppmmg-,v-pppmng-
Κορίνθιοί	n-p---mn-	a-p---mn-,a-p---mv-
ἐπὲων	v-sppamn-	n-p---ng-
Ἐφέσιοι	n-p---mn-	a-p---mn-,a-p---mv-
Ἴωσι	n-p---mg-	n-p---md-,v3ppsa---,v3ppsa---,n-s---fv-
θῆται	v3sase---	v3spse---,v3spie---,v3spie---,v3sasm---,v3sfim---,v3spsm---,v3spim---
ἡμέας	p-p---ma-	p1p---ma-,p1p---fa-
γῶν	d--------	g--------
Κλέοβίν	n-s---ma-	n-s---fa-
Ἀργείοισι	n-p---md-	a-p---md-,a-p---nd-
ὠχέετο	v3siip---	v3siie---,v3siie---
Ἀργεῖαι	n-p---fn-	a-p---fn-,a-p---fv-,v2spie---
ἀριστῶν	a-s---mg-	v-sppamv-,v-sppann-,v-sppanv-,v-sppana-,v-sppamn-,v-sppamn-
μακρότερον	a-s---fac	d--------,a-s---mac,a-s---nnc,a-s---nvc,a-s---nac
τουτέων	a-p---fg-	p-p---fg-
αὐτέων	a-p---fg-	p-p---mg-,p-p---fg-
δυοῖσι	a-p---nd-	m-p---md-,m-p---fd-,m-p---nd-,v-pppamd-,v-pppand-
κω	d--------	g--------
χώρη	n-s---fd-	n-s---fn-,n-s---fv-,v2spma---,v3siia---
κῇ	d--------	v2spse---,v2spie---,v3spsa---,g--------,n--------
τοιοῦτο	a-s---na-	p-s---nn-
φονεύσας	v-sppamn-	v-pppafa-,v-sppafg-,v-sapamn-,v-sapamv-,v-pppafa-
σευ	p-s---mg-	p2s----g-
λογάδας	a-p---ma-	n-p---fa-,n-p---ma-,n-p---fa-
φαμένου	v-sppemg-	v-sppmmg-,v-sppmng-
κοτὲ	d--------	g--------
γενναιότατα	a-------s	d--------,a-p---nns,a-p---nvs,a-p---nas,d--------,a-p---nns,a-p---nvs,a-p---nas
φαίνεσθαι	v--pnp---	v--pne---
ἄχαρι	a-s---na-	n-s---mv-,n-s---fv-,n-s---nn-,n-s---nv-,n-s---na-
ἀχάρι	a-s---fd-	n-s----d-
παρέχων	v-spiamn-	v3piia---,v1siia---,v-sppamn-
τοιῇδε	a-s---fd-	p-s---fd-
λογάσι	a-p---md-	n-p---fd-,n-p---md-,n-p---fd-
σφέα	p-p---na-	p-p---n--
Ἀμφιάρεω	n-s---mg-	n-s---fg-
φιάλας	n-p---ma-	n-p---fa-,n-s---fg-,v-sapamn-,v-sapamv-,v-sapamn-,v-sapamv-
ἡμιτάλαντον	n-s---ma-	n-s---nn-,n-s---nv-,n-s---na-
Κλαζομενίων	n-p---mg-	a-p---fg-,a-p---mg-,a-p---ng-
Λακεδαιμονίοισι	n-p---md-	a-p---md-,a-p---nd-
Ἀμφιάρεῳ	n-s---md-	n-p---fn-,n-s---fd-
Θηβέων	n-p---mg-	n-p---fg-
Πυθὼ	n-s---fa-	n-s---fn-
ἐξανέστη	v3slia---	v1slia---,v3saia---
Καδμείων	n-p---mg-	a-p---fg-,a-p---mg-,a-p---ng-,a-p---fg-,a-p---mg-,a-p---ng-,n-s---mn-,n-s---fn-,n-s---mv-,n-s---fv-
Δωρικὸν	n-s---ma-	a-s---ma-,a-s---nn-,a-s---nv-,a-s---na-
ἥντινα	a-s---fa-	p-s---fa-
Τυρσηνῶν	n-p---mg-	a-p---fg-,a-p---mg-,a-p---ng-
Κρηστῶνα	n-p---nd-	a-p---nn-,a-p---nv-,a-p---na-
Πελασγικὰ	n-p---na-	a-p---nn-,a-p---nv-,a-p---na-,a-d---fn-,a-d---fv-,a-d---fa-,a-s---fn-,a-s---fv-
κοτε	d--------	g--------
τεο	p-s---ng-	p2s----g-,p-s----g-
δευτέρα	a-p---na-	a-d---fn-,a-d---fv-,a-d---fa-,a-s---fn-,a-s---fv-
δεξιώτερον	a-s---fnc	d--------,a-s---mac,a-s---nnc,a-s---nvc,a-s---nac
ἠλιθίου	a-s---fg-	a-s---mg-,a-s---ng-,v3siia---,v2spma---,v3siia---
φανέεσθαι	v--fne---	v--fnm---,v--pne---
συνιόντων	v--ppamg-	v-pppamg-,v-pppang-,v3ppma---,v-pppamg-,v-pppang-
ἱροῦ	n-s---ng-	v2siie---,v2spme---,v2siie---,a-s---mg-,a-s---ng-,v2siie---,v2spme---,a-s---mg-,a-s---ng-
πίονα	a-s---ma-	n-s---ma-,n-s---fa-
πλήθεϊ	a-s---fd-	v2spie---,v3spia---,n-d---nn-,n-d---nv-,n-d---na-,n-s---nd-,n-s---nd-
ἀνά	d--------	r--------
τοῦτὸν	a-s---ma-	p-s---ma-
διαπεμπομένους	v-ppppma-	v-pppema-
ὅκου	c--------	d--------
ἐπέτυχον	v1paia---	v3paia---,v1saia---
ἑπταπήχεϊ	a-s---fd-	a-s---md-,a-s---nd-,a-s---md-,a-s---nd-
Σαμίην	n-s---fa-	a-s---fa-,a-s---fa-
πριαμένους	v-pppema-	v-pppmma-
τοιούτους	a-p---ma-	p-p---ma-
τοῖσί	p-p---md-	l-p---md-,l-p---nd-,x-p----d-
Σύριοι	n-p---mn-	a-p---mn-,a-p---mv-
ἀναισιμοῦνται	v3ppip---	v3ppie---
πέρ	d--------	g--------
κῶς	d--------	n--------,g--------
κῃ	d--------	g--------
ἐπείθοντο	v3piip---	v3piie---
περιγένωνται	v3pasa---	v3pasm---
λογάδες	a-p---mn-	n-p---fn-,n-p---fv-,n-p---mn-,n-p---fn-,n-p---mv-,n-p---fv-
νικᾶν	v-sppa---	n-p---fg-,v-sppamv-,v-sppann-,v-sppanv-,v-sppana-,v-sppamn-,v--pna---,v--pna---
ἀνασώσωνται	v3pasa---	v3pasm---
ἔχοιτο	v3spop---	v3spoe---
κοτέ	d--------	g--------
Μήλης	n-s---mn-	a-s---fg-,n-s---fg-
αὐδήσει	v3sfia---	v2stie---,v3sasa---,v2stie---,v3stia---
τεσσερεσκαίδεκα	a--------	m-p---m--,m-p---f--
ῥύσεται	v3sfia---	v3sasm---,v3sfim---
ὄχλον	n-s---na-	n-s---ma-
τοὶ	p-s---md-	l-p---mn-,p2s----d-,p2s----d-,g--------
τιθέντας	v-sppama-	v-pppama-
τρία	a-p---na-	m-p---nn-,m-p---nv-,m-p---na-,n-p---nn-,n-p---nv-,n-p---na-
ἔνερθε	d--------	r--------
τρίπους	n-s---mn-	n-p---ma-,a-s---mn-,a-s---fn-,a-s---mv-,a-s---fv-,a-p---ma-
Προνηίης	n-s---fg-	a-s---fg-
Τυρσηνίην	n-s---fa-	a-s---fa-
ἀλλέων	a-p---fg-	p-p---mg-,p-p---fg-
Τυρσηνόν	n-s---ma-	a-s---ma-,a-s---nn-,a-s---nv-,a-s---na-
Τυρσηνούς	n-p---ma-	a-p---ma-
ἐπιδίζηται	v3spip---	v3spie---,v3spse---
οὐδενὶ	p-s---md-	p-s----d-
ἄλλῳ	a-s---md-	p-s---nd-,p-s---md-
πλεῦνος	a-s---mg-	a-s----g-
δικᾶν	n-s---fa-	n-p---fg-,v-sfpamv-,v-sfpann-,v-sfpanv-,v-sfpana-,v-sfpamn-,v--fna---
ἡμέων	p-p---mg-	p1p---mg-,p1p---fg-,a-p---mg-,a-p---fg-
μαχομένοισι	v-papmmd-	v-pppemd-,v-pppend-
περικατημένῳ	v-srpemd-	v-srpmmd-,v-srpmnd-
Σάσπειρες	n-p---mn-	n-s---mv-
ἀποτράπει	v3spia---	v2spma---,v3siia---
πλεόνων	a-p---mgc	a-p----gc
ἱρῶν	n-p---ng-	a-p---fg-,a-p---mg-,a-p---ng-,v-sppamv-,v-sppann-,v-sppanv-,v-sppana-,v-sppamn-,v--pna---,a-p---fg-,a-p---mg-,a-p---ng-
Καὶ	d--------	c--------
παραχρήσῃ	v2sasa---	n-s---fd-,v2sase---,v2sfie---,v2sasm---,v3sasa---,v2sfim---
ὑστέρης	a-s---fgc	a-s---fg-,n-s---fg-,v2siia---,v2siia---
ἔρσενος	n-s---mg-	n-s----g-
ἐπιτηδεοτάτας	a-p---fas	a-p---fa-,a-s---fg-
εἶδόν	v1paia---	v3paia---,v1saia---
σφεα	p-p---na-	p-p---n--
μηδεμιῇ	a-s---fd-	p-s---fd-
κάκιστα	a-p---nas	a-p---nn-,a-p---nv-,a-p---na-
ἐδόκεον	v1piia---	v3piia---,v1siia---
γεγονότα	v-srpamd-	v-prpann-,v-prpanv-,v-prpana-,v-srpama-
ἐβούλευον	v1piia---	v3piia---,v1siia---
ἄχρι	r--------	d--------
ἀπηγέετο	v3siie---	v3siim---,v3siim---,v3siim---
μηλέων	n-p---ng-	n-p---fg-
θειοτέρως	d-------c	d--------,a-p---mac
φυλασσομενέων	v-ppppfg-	v-pppemg-,v-pppefg-,v-pfpmmg-,v-pfpmfg-
ἀναπείσας	v-sappmn-	v-pappfa-,v-sappfg-,v-sapamn-,v-sapamv-
πειρήσονται	v3pfia---	v3pfim---
ὀκτωκαίδεκα	a--------	m--------
βουλήσεται	v3sfia---	v3sfim---
τοιοῖσιδε	a-p---md-	p-p---md-,p-p---nd-
Ἀραβίων	n-s---mn-	a-p---fg-,a-p---mg-,a-p---ng-,v-sppamn-
Ἀράβιοι	n-p---mn-	a-p---mn-,a-p---mv-
προβάτων	n-p---mg-	n-p---ng-,v3dama---
ἅδῃ	v3sasp---	v2sase---,v3sasa---,v2spse---,v2spie---
κτείνουσι	v3paia---	v3pasa---,v-pppamd-,v-pppand-,v3ppia---
ἐπεῖ	c--------	v2spia---
ψυχροῦ	n-s---ng-	v2spme---,v2siie---,a-s---mg-,a-s---ng-
παραγωγέων	n-p---ng-	n-p---mg-,n-p---mg-,n-p---fg-
Καρίῃ	n-s---fd-	a-s---fd-
Ἐρυθραῖοι	n-p---mn-	a-p---mn-,a-p---mv-
ἱδρύσαντο	v3paia---	v3paim---,v3paim---
Σμυρναῖοι	n-p---mn-	a-p---mn-,a-p---mv-,a-p---mn-,a-p---mv-
Ῥύπες	n-p---ma-	n-s---mv-
Καδμεῖοι	n-p---mn-	a-p---mn-,a-p---mv-
Μολοσσοὶ	n-p---mn-	a-p---mn-,a-p---fn-,a-p---mv-,a-p---fv-
ἠγάγοντο	v3paia---	v3paim---
αὐτῇσι	a-p---fd-	p-p---fd-
Ἐφεσίων	n-p---mg-	n-p---ng-,a-p---fg-,a-p---mg-,a-p---ng-,n-p---fg-,v-sfpamn-
Κολοφωνίων	n-p---mg-	a-p---fg-,a-p---mg-,a-p---ng-,v-sppamn-
Αἰγαῖαι	n-p---fn-	a-p---fn-,a-p---fv-
τῆ	l-s---fd-	v2sama---
ἥκουσαν	v-sppa---	v-sppafa-
Σμυρναίους	n-p---ma-	a-p---ma-,a-p---ma-
Σμυρναίων	n-p---mg-	a-p---fg-,a-p---mg-,a-p---ng-,a-p---fg-,a-p---mg-,a-p---ng-
Μηθυμναῖοι	n-p---mn-	a-p---mn-,a-p---mv-
Λεσβίοισι	n-p---md-	a-p---md-,a-p---nd-,a-p---md-,a-p---nd-
Τενεδίοισι	n-p---md-	a-p---md-,a-p---nd-
Σπαρτιήτην	a-s---ma-	n-s---ma-
μέση	a-s---fd-	n-s---fn-,n-s---fv-,n-s---mv-,a-s---fn-,a-s---fv-
Κυμαῖοι	n-p---mn-	a-p---mn-,a-p---mv-
ἀνοῖσαι	v--ana---	v-pppafn-,v-pppafv-
αἵρεε	v3spia---	v2spma---,v3siia---
τοιῶδε	a-s---mg-	p-s---mg-,p-s---ng-
Τυρσηνοὶ	n-p---mn-	a-p---mn-,a-p---mv-
τῶ	p-s---md-	l-s---mg-,l-s---ng-,d--------
περιτείνουσι	v3paia---	v3pasa---,v-pppamd-,v-pppand-,v3ppia---
μισέλλην	n-s---mn-	n-s----n-,n-s----v-
ἐχθρός	n-s---mn-	a-s---mn-
ἰάσασθαι	v--ane---	v--anm---
μείζονι	a-s---ndc	a-s----dc
πολέμιοι	n-p---mn-	a-p---mn-,a-p---mv-,a-p---mn-,a-p---fn-,a-p---mv-,a-p---fv-
ἡγεῖσθαι	v--pne---	v--pnm---
τοσαύτη	a-s---fn-	p-s---fn-,p-s---fv-
ποθὲν	d--------	v-sappnn-,v-sappnv-,v-sappna-,g--------
Κυζικηνῶν	n-p---mg-	a-p---fg-,a-p---mg-,a-p---ng-,a-p---fg-,a-p---mg-,a-p---ng-,a-p---fg-,a-p---mg-,a-p---ng-
Ἀβυδηνῶν	n-p---mg-	a-p---fg-,a-p---mg-,a-p---ng-
Βυζαντίους	n-p---ma-	a-p---ma-
Βυζαντίων	n-p---mg-	a-p---fg-,a-p---mg-,a-p---ng-,n-p---ng-
Δοῦρις	n-s---mn-	n-s---fn-
Πλυντήρια	n-p---na-	a-p---nn-,a-p---nv-,a-p---na-
Χίους	n-p---ma-	n-p---fa-,a-p---ma-,v2siia---
Καρίας	n-s---fg-	a-p---fa-,a-s---fg-
ἀλαζονεύεσθαι	v--pne---	v--pnm---
Τιμάνδρα	n-s---fn-	n-d---fn-,n-d---fv-,n-d---fa-
τινῶν	p-p---mg-	p-p----g-
ἐξαλλόμενον	v-sppema-	v-sppmma-,v-sppmnn-,v-sppmnv-,v-sppmna-
Οἰδίπους	n-s---mn-	a-s---mn-,a-s---fn-,a-s---mv-,a-s---fv-
προσήμεθα	v1ppie---	v1ppim---
Οἰδίπου	n-s---mg-	a-s---nn-,a-s---nv-,a-s---na-
κήδευμα	n-s---mv-	n-s---nn-,n-s---nv-,n-s---na-
τοιαύτῃ	a-s---fd-	p-s---fd-
προτέρας	a-s---fgc	a-p---fa-,a-s---fg-
ἄλλαν	a-p---fn-	p-s---fa-
περιβόατον	a-s---mn-	a-s---ma-,a-s---fa-,a-s---nn-,a-s---nv-,a-s---na-
ὕστερος	a-s---mnc	a-s---mn-
χαὐτοῦ	a-s---mg-	p-s---ng-,p-s---mg-
ῥᾷστα	d-------s	a-p---nn-,a-p---nv-,a-p---na-
δεινόπους	n-s---fn-	a-s---mn-,a-s---fn-,a-s---mv-,a-s---fv-
ἐπαισθάνει	v2spie---	v2spim---
ἀελλάδων	a-p---fg-	n-p---fg-
Οἰδίπουν	n-s---ma-	a-s---ma-,a-s---fa-
αὑτός	a-s---mn-	p-s---mn-
πύματον	a-s---nas	a-s---ma-,a-s---nn-,a-s---nv-,a-s---na-
αὑταῖς	a-p---fd-	p-p---fd-
κἀκείνου	a-s---mg-	p-s---ng-,p-s---mg-,v3siia---
Μερόπη	n-s---mn-	n-s---fn-,n-s---fv-
ὑψίποδες	n-p---mn-	a-p---mn-,a-p---fn-,a-p---mv-,a-p---fv-
αἰθέρα	n-s---fa-	n-s---ma-
ἀνέρων	n-p---mg-	v3piia---,v1siia---,v3piia---,v1siia---
οὐδενός	p-s---ng-	p-s----g-
ὅμοῦ	d--------	v2spma---,v3siia---
μηδενί	n-s---md-	p-s----d-
λῷστά	a-p---nas	a-p---nn-,a-p---nv-,a-p---na-,a-p---nn-,a-p---nv-,a-p---na-
ἦρα	n-s---ma-	v1saia---,n-p---nn-,n-p---nv-,n-p---na-,n-p---nn-,n-p---nv-,n-p---na-
προύχοις	v2spoa---	v2sroa---
τίσι	n-p---md-	x-p----d-,n-s---fv-,n-s---fd-,p-p----d-
κοὐδέν	a-s---nn-	p-s---nn-,p-s---nv-,p-s---na-
εὐδαίμονος	a-s---mg-	a-s----g-
ἐκείνοισιν	a-p---nd-	p-p---nd-,p-p---md-
αὐδῶν	v-sppamn-	v-sfpamv-,v-sfpann-,v-sfpanv-,v-sfpana-,v-sfpamn-,n-p---fg-
πάροιθε	d--------	r--------
μακίστων	a-p---ngs	a-p---fg-,a-p---mg-,a-p---ng-
δυσδαίμονι	a-s---fd-	a-s----d-
ἐξήλλου	v2siie---	v2siim---
ἐπιπλόμενον	v-sppenv-	v-sppmma-,v-sppmnn-,v-sppmnv-,v-sppmna-
ἥκιστά	a-p---nas	a-p---nn-,a-p---nv-,a-p---na-
κάκιστον	a-s---mas	a-s---ma-,a-s---nn-,a-s---nv-,a-s---na-
πρακτέαν	a-s---nn-	a-s---fa-
φίλοιν	a-d---fg-	a-d---mg-,a-d---ng-,a-d---md-,a-d---nd-
δακρυρροούντοιν	v-dppafg-	v-dppamg-,v-dppang-,v-dppamd-,v-dppand-
ὑμίν	p-p---fd-	p2p----d-
ταύταιν	a-d---fd-	p-d---fd-,p-d---fg-
Εὐθύφρων	n-s---mv-	a-s---mn-,a-s---fn-
ἀγνώς	c--------	n-s---mn-,n-s---fn-
τετανότριχα	n-s---ma-	a-s---ma-,a-s---fa-
ὅτιπερ	p-s---na-	c--------
ἐπεξῇσθα	v2s-i----	v2spsa---,v2sasa---,v2sasa---
Εὐθύφρονα	n-s---ma-	a-p---nn-,a-p---nv-,a-p---na-,a-s---ma-,a-s---fa-
ἡγοῦ	v2spme---	v2siie---,v2siim---,v2spmm---,v2siim---,v2siim---,n-s---mg-
κἀκεῖνόν	a-s---ma-	p-s---ma-
ἡγῇ	v2spie---	v2spsm---,v2spim---
πότε	p--------	n--------,n-s---mv-,g--------
ἡγείσθων	v3ppme---	v3ppmm---,v3dpmm---
ὁτιδὴ	p-s---nn-	d--------,c--------
συμπροθυμήσομαι	v1sfia---	v1sase---,v1sfie---,v1sasm---,v1sfim---
ἰδὲ	v2sa-----	d--------,c--------
σαυτόν	p2s---m--	p-s---ma-,p-s---na-,p-s---ma-
ὁσιότης	n-s---fn-	n-s---mn-
ἡγούμενός	v-sppemn-	v-sppmmn-
αἰσθάνῃ	v2spie---	v2spsm---,v2spim---
Ἄργην	n-s---ma-	n-s---fa-,n-s---na-
Τάρταρον	n-s---ma-	n-s---fa-
Ταρτάρῳ	n-s---md-	n-s---fd-
Ἄτροπον	n-s---fa-	n-s---ma-,a-s---ma-,a-s---fa-,a-s---nn-,a-s---nv-,a-s---na-
γεγενημένοις	v-prp-nd-	v-prpemd-,v-prpend-
ἡγοῖσθε	v2ppoe---	v2ppom---
ἐγνωσμένα	v-prp-nn-	v-prpenn-,v-prpenv-,v-prpena-,v-drpefn-,v-drpefv-,v-drpefa-,v-srpefn-,v-srpefv-
χείριστον	a-s---mas	a-s---ma-,a-s---nn-,a-s---nv-,a-s---na-,a-s---ma-,a-s---nn-,a-s---nv-,a-s---na-
οἴεται	v3spi----	v3spie---
ἡγεῖται	v3spie---	v3spim---
ἡγοῦμαι	v1spie---	v1spim---
-τε	d--------	g--------
ἡγούμενος	v-sppemn-	v-sppmmn-
ἀγὼ	p-s---mn-	n-d---mn-,n-d---mv-,n-d---ma-
μηδεμιᾷ	a-s---fd-	p-s---fd-
ᾡτινιοῦν	a-s---md-	p-s---md-,p-s---nd-
καίτοιγε	d--------	g--------
γραφάς	n-s---fg-	n-p---fa-,n-p---ma-,n-s---mn-
Ἀλέξιδος	n-s---mg-	n-s---fg-
πεποιῆσθαι	v--rnp---	v--rne---
δεδουλῶσθαι	v--rnp---	v--rne---
βλάπτεσθαι	v--pnp---	v--pne---
ὠκύτατόν	a-s---mas	a-s---ma-,a-s---nn-,a-s---nv-,a-s---na-
Ἀνάνιος	n-s---mg-	n-s---mn-,a-s---mn-,a-s---fn-
ἀλαζονίστατον	a-s---nns	a-s---ma-,a-s---nn-,a-s---nv-,a-s---na-
ὀλίγιστον	a-s---mas	a-s---ma-,a-s---nn-,a-s---nv-,a-s---na-
Ἐπικουρείων	n-p---mg-	a-p---mg-,a-p---fg-,a-p---ng-
πῄ	d--------	g--------
δαί	d--------	g--------,n-s---fv-,n-s---fv-
ἥδεσθαι	v--pnp---	v--pne---
φέριστον	a-s---nns	a-s---ma-,a-s---nn-,a-s---nv-,a-s---na-
ἀκουάζωνται	v3ppse---	v3ppsm---
πλείστης	a-s---fgs	a-s---fg-
πρεσβύτερος	a-s---mnc	a-s---mn-
ἥμενοι	v-prpemn-	v-prpmmn-,v-prpmmv-
εἴδεται	v3spie---	v3spim---
ᾠήθη	v3said---	v3saip---,v3saip---
πουλύπους	n-s---mn-	a-s---mn-,a-s---mv-,n-p---ma-
πέτρᾳ	n-p---fd-	n-p---fn-,n-p---fv-,n-s---fd-
καθήμενοι	v-prpemn-	v-prpmmn-,v-prpmmv-
ἠγορόωντο	v3piie---	v3piim---
κεν	d--------	g--------
ἥμεθα	v1piie---	v1prim---,v1plim---,v1piim---,v1ppim---
τίθεται	v3spid---	v3spie---
ἐπετίθεντο	v3piid---	v3piie---
Δίνων	n-s---mn-	v-sppamn-,n-p---mg-,n-p---mg-,v3piia---,v1siia---
καθήλλετο	v3siie---	v3siim---
ἐτίθετο	v3siip---	v3siie---
Σολεὺς	a-s---mn-	n-s---mn-
προσηγορεύετο	v3siip---	v3siie---
Ἀμύντας	n-p---mn-	n-p---ma-,n-s---mn-,n-p---ma-,n-s---mn-
βότρυας	n-p---ma-	n-p---fa-
ἀνακεῖσθαι	v--pnp---	v--pne---,v--pne---
καθῆσθαι	v--rne---	v--rnm---
πορφύρᾳ	n-p---fd-	n-p---fn-,n-p---fv-,n-s---fd-
γράψοντας	v-papama-	v-pfpama-
Ταραντῖνος	a-s---mn-	n-s---mn-
Ἄλεξις	n-s---mn-	n-s---fn-,n-s---fn-
ταγηνιῶν	n-p----g-	n-p---mg-,v-sfpamn-
Τυρρηνοῖς	n-p---md-	a-p---md-,a-p---nd-,a-p---md-,a-p---nd-
ὁτὲ	d--------	c--------
Μεσσαπίων	n-p---mg-	a-p---fg-,a-p---mg-,a-p---ng-
Τυρρηνοί	n-p---mn-	a-p---mn-,a-p---mv-,a-p---mn-,a-p---mv-
λουτροχόοι	n-p---mn-	a-p---mn-,a-p---fn-,a-p---mv-,a-p---fv-
τισι	p-p---md-	p-p----d-
χῆνα	n-s---ma-	n-s---fa-
Ταραντῖνον	a-s---ma-	n-s---ma-
ἀφιεμένοις	v-pppemd-	v-pppmmd-,v-pppmnd-
Μελιταίοις	n-p---nd-	n-p---md-,a-p---md-,a-p---nd-
Βισάλται	n-p---mn-	n-s---md-
ἐγχέλεις	n-p---fa-	n-p---fn-,n-p---fv-
Ὀλυμπίων	n-p---mg-	n-p---ng-,a-p---mg-,a-p---fg-,a-p---ng-,n-p---ng-
νομίμους	a-p---fa-	a-p---ma-
κρείττοσιν	a-p---mdc	a-p----dc
Κολοφώνιοι	n-p---mn-	a-p---mn-,a-p---mv-
ἐκαλοῦντο	v3piip---	v3piie---
Θάσου	n-s---fg-	n-s---mg-
ἥσσονός	a-s---fgc	a-s----gc
τοιγάρτοι	d--------	g--------
Γεργίθων	n-p---mg-	n-p---fg-
ἄδακρυς	a-s---fn-	a-s---mn-
Ἀβυδηνοὶ	n-p---mn-	a-p---mn-,a-p---mv-
ἁφῶν	n-p---mg-	v-sppamv-,v-sppann-,v-sppanv-,v-sppana-,v-sppamn-,n-p---fg-
Ἀντιφάνης	n-s---m--	n-p---ma-,n-p---mn-,n-p---mv-,n-s---mn-
Φιλιππικῶν	n-p---mg-	a-p---fg-,a-p---mg-,a-p---ng-
Καλχηδονίων	n-p---mg-	a-p---fg-,a-p---mg-,a-p---ng-
Βυζάντιοι	n-p---mn-	a-p---mn-,a-p---mv-
Καλχηδόνιοι	n-p---mn-	a-p---mn-,a-p---mv-
βελτίονι	a-s---mdc	a-s----dc
Ποσειδώνιος	n-s---mn-	a-s---mn-
Λυκίας	n-s---fn-	a-p---fa-,a-s---fg-,n-p---fa-,n-s---fg-
χρεῶν	a-p---ng-	n-p---fg-,n-p---ng-,n-p---fg-
Ζακυνθίους	n-p---ma-	a-p---ma-
Ῥωμαίους	n-p---ma-	a-p---ma-,a-p---ma-
κουρίμου	a-s---fg-	a-s---mg-,a-s---ng-
ἐσθῆσι	n-s---fd-	n-p---nd-,n-p---fd-,v3spsa---,v2spsm---,v2sasm---,v3sasa---
τεσσάρων	a-p---ng-	n-p---mg-,n-p---fg-,n-p---ng-
Νίνῳ	n-s---fd-	n-s---md-,n-s---md-,n-s---nd-
οὐ	---------	d--------
Μνασέας	n-p---mn-	n-p---ma-,n-s---mn-
Σάγαριν	n-s---ma-	n-s---fa-
Μαριανδυνὸν	a-s---ma-	n-s---ma-
μασώμενος	v-sppemn-	v-sppmmn-
Χαλκηδόνιον	a-s---ma-	n-s---ma-,n-s---nn-,n-s---nv-,n-s---na-
Βαβυλωνίας	n-s---fg-	a-p---fa-,a-s---fg-
ἔριφον	v2paia---	n-s---ma-
τοσαύτην	a-s---fa-	p-s---fa-
Χάρητος	n-s---mg-	n-s----g-
Χάρητι	n-s---md-	n-s----d-,v2samp---
Ἀδαῖος	n-s---mn-	a-s---mn-,a-s---fn-
τέτταρας	a-p---ma-	n-p---ma-,n-p---fa-,m-p---ma-,m-p---fa-
Μαγνητικῶν	a-p----g-	a-p---fg-,a-p---mg-,a-p---ng-,a-p---fg-,a-p---mg-,a-p---ng-
Κύκης	n-s---fg-	v2spia---,v2siia---
τέσσαρσι	a-p---fd-	n-p----d-,n-p---md-,n-p---fd-,n-p---nd-
καθημένη	v-srpefn-	v-srpmfn-,v-srpmfv-
Μεδοντίδα	n-s---fa-	n-d---mn-,n-d---mv-,n-d---ma-,n-s---mg-
Εὐπόλιδος	n-s---mg-	n-s---fg-,n-s---fg-
δώδεκα	a--------	m--------
Νύμφις	n-s---mn-	n-s---fn-
Ἡρακλεώτης	a-s---mn-	n-s---mn-
ἐλάττονι	a-s---ndc	a-s----dc
παραδείσω	n-s---md-	n-d---mn-,n-d---mv-,n-d---ma-,n-s---mg-
ἐνενήκοντα	a-p---ma-	m--------
χρυσόπους	a-s---fn-	a-s---mn-,a-s---mv-
πορφυροῖς	a-s----d-	a-p---md-,a-p---nd-,v2sfoa---,v2spoa---
περιχρύσους	a-s---ma-	a-p---ma-,a-p---fa-,v2siia---
Χαλκιδεύς	a-s---mn-	n-s---mn-
ἕω	n-s---fg-	n-s---fa-,n-d---fn-,n-d---fv-,n-d---fa-
Ἄγνων	n-s---mn-	n-p---fg-,n-p---mg-
πορφυρῶν	n-p---ng-	n-p---fg-,a-p---fg-,a-p---mg-,a-p---ng-,v-sfpamn-,v-sppamn-
σμαραγδίνους	a-p---fa-	a-p---ma-
ἐνδῦσαι	v-pana---	v-papafn-,v-papafv-
ὗς	n-p---ma-	n-p---mn-,n-p---fn-,n-s---mn-,n-s---fn-
Λακαίνας	a-p---fa-	n-p---fa-,n-s---fg-
μισθοῖς	n-s---md-	n-p---md-,v2spoa---,v2spsa---,v2spia---
δημιουργῶν	a-p---fg-	v-sppamn-,n-p---mg-
εὐγενέτας	a-s---mn-	n-p---ma-,n-s---mn-
Καρύστιος	n-s---mn-	a-s---mn-
Ἱμεραίου	n-s---mg-	a-s---mg-,a-s---ng-,a-s---mg-,a-s---ng-
ἐπιφάνεια	n-p---na-	n-s---fn-,n-s---fv-
κάλλιστοι	a-p---mns	a-p---mn-,a-p---mv-
ῥὰ	d--------	g--------
τισὶ	p-p---md-	p-p----d-
ἁπαλόν	a-s---mn-	a-s---ma-,a-s---nn-,a-s---nv-,a-s---na-
πολύαρχον	n-s---ma-	a-s---ma-,a-s---fa-,a-s---nn-,a-s---nv-,a-s---na-
ἀρετῶν	n-s---fg-	v-sppamv-,v-sppann-,v-sppanv-,v-sppana-,v-sppamn-,n-p---fg-
ἔμφρονος	a-s---mg-	a-s----g-
μεγίσταις	a-p---fds	a-p---fd-
πριαίμην	v1spoe---	v1spom---
βαθύτερον	a-s---mac	a-s---ma-,a-s---nn-,a-s---nv-,a-s---na-
δυσὶν	a-p---md-	m-p---md-,m-p---fd-,m-p---nd-
καθαλλόμενος	v-sppemn-	v-sppmmn-
ὁρμῶσιν	v3pasa---	v-pppamd-,v-pppand-,v3ppsa---,v3ppia---,v3ppsa---,v-pfpamd-,v-pfpand-,v3pfia---,v3ppsa---
παχυτέραν	a-s---fac	a-s---fa-
Ταναγραίῳ	n-s---nd-	n-s---md-,n-s---md-
Φθιῶτα	n-s---na-	n-s---mv-,n-s---mn-,n-s---mv-,n-s---mn-
Φανίου	n-s---mg-	n-s---ng-
ἠκροᾶτο	v3siie---	v3siim---
Σκήψιος	a-s---mn-	n-s---mn-,n-s---fg-
Ἀλειπτικῆς	n-s---fg-	a-s---fg-
εὐτελὴς	a-s---nn-	a-s---mn-,a-s---fn-
πρίω	v2spme---	v2spmm---,v2siim---,v1spsa---,v1spia---,v2spma---
Ζακυνθίῳ	n-s---md-	a-s---md-,a-s---nd-
γνάθους	n-p---fd-	n-p---fa-,v2siia---
οὗπερ	p-s---ng-	d--------
Ἐρωτικοῖς	n-p---md-	a-p---md-,a-p---nd-
ἐπικοσμεῖται	v3spia---	v3spie---,v3spie---
Καλλιπύγου	n-s---fg-	n-s---mg-,n-s---mg-
καλαὶ	n-p---fn-	n-s---fv-,a-p---fn-,a-p---fv-
υἱοῖς	n-p---mg-	n-p---md-,v2spoa---,v2spsa---,v2spia---
καλλίπυγοι	n-p---fn-	n-p---mn-,n-p---mv-
Μεγαλοπολίτης	n-p---mn-	n-s---mn-,n-s---mn-
Κερκιδᾶς	n-s---mn-	n-p---ma-
καλλιπύγων	n-p---fg-	n-p---mg-
λαμπρᾶς	a-p---fa-	a-s---fg-
ἡντινοῦν	a-s---fa-	p-s---fa-
καθέζετο	v3saia---	v3saim---,v3siie---,v3siim---
λαγὼ	n-s---mg-	n-d---mn-,n-d---mv-,n-d---ma-
ἴτων	v3ppma---	v3dpma---,n-p---ng-
ἥμενος	v-srp-mn-	v-srpmmn-
ἰατρόμαντις	n-s---mn-	n-s---fn-
δικεῖν	v--pna---	v--ana---
ἄλλοισιν	a-p---md-	p-p---nd-,p-p---md-
σώφροσιν	a-p---md-	a-p----d-
ἀρόμενον	v-sap-ma-	v-srpema-,v-srpenn-,v-srpenv-,v-srpena-,v-sppema-,v-sppenn-,v-sppenv-,v-sppena-,v-sapmma-,v-sapmnn-,v-sapmnv-,v-sapmna-
κἀμοί	p-s---fd-	a-p---mn-,a-p---mv-,v2spse---,v2spie---,v3spsa---,p1s---md-,p1s---fd-,a-p---mn-,a-p---mv-,a-p---mn-,a-p---mv-
καρανιστῆρες	a-p---fn-	n-p---mn-,n-p---mv-
ἐκματεύομεν	v1spi----	v1ppia---,v1piia---
ἁμὶν	p-p---fd-	p1p---md-,p1p---fd-
ἱέμεναι	v-pppefn-	v--pna---,v-pppmfn-,v-pppmfv-
μελανείμοσιν	a-p---fd-	a-p----d-
σμοῖς	n-p---md-	v2spoa---,v2spsa---,v2spia---
ἄφρονι	a-s---fd-	a-s----d-
αὐδᾶ	---------	v1spsa---,v1spia---,v1sfia---
τέλειοι	a-p---fn-	a-p---mn-,a-p---mv-
δερκομένοισι	v-pppemd-	v-pppmmd-,v-pppmnd-
ἐφημένῳ	v-sppemd-	v-srpmmd-,v-srpmnd-
ἧσαι	v2spie---	v2samm---,v2srim---,v2spim---
ματροκτόνου	n-s---mg-	a-s---mg-,a-s---fg-,a-s---ng-
τοκεῦ	---------	v2spme---,v2siie---,n-s---mv-
ὑπόδοσίν	n-s---fa-	n-s---ma-
τλά	---------	v3saia---
ὁμοί	---------	a-p---mn-,a-p---mv-,v2spse---,v2spie---,v3spsa---
ἀνάρχετον	a-s---ma-	v2diia---,v2dpma---,v3dpia---,v2dpia---,v2diia---
ἄλλᾳ	d--------	p-p---fn-,p-p---fv-,p-s---fd-
ψεύσομαι	v1sfi----	v1sasm---,v1sfim---
ἐφήμενοι	v-ppp-mv-	v-prpmmn-,v-prpmmv-
εὔφροσιν	a-p---md-	a-p----d-
ἀτέρμονι	a-s---md-	a-s----d-
δαιδάλῳ	n-s---md-	a-s---md-,a-s---fd-,a-s---nd-
τοκεύς	n-s---fn-	n-s---mn-
ξύμβουλός	n-s---fn-	n-s---mn-
κἄγωγε	p-s---mn-	p1s---mn-,p1s---fn-,p1s---mv-,p1s---fv-
βρωτῆρας	n-p---fa-	n-p---ma-
ἡμένας	v-prpefa-	v-prpmfa-,v-srpmfg-
ξυνοικήτωρ	n-s---fn-	n-s---mn-
μᾶν	n-p---fg-	n-p---mg-
γεραιτέρα	a-s---fnc	a-d---fn-,a-d---fv-,a-d---fa-,a-s---fn-,a-s---fv-
ἀνδροτυχεῖς	a-s---ma-	a-p---ma-,a-p---fa-,a-p---mn-,a-p---fn-,a-p---mv-,a-p---fv-
ματροκασιγνῆται	a-p---fv-	n-p---mn-,n-p---mv-
γάνυμαι	v1spie---	v1spim---
χὐμεῖς	p-s---fn-	p2p----n-
μετοίκοις	n-p---fd-	n-p---md-
νέμον	---------	v-sppamv-,v-sppann-,v-sppanv-,v-sppana-,v3piia---,v1siia---
προσπόλοισιν	n-p---fd-	n-p---md-
σύμφρονες	a-p---fn-	n-p---mn-,n-p---fn-,n-p---mv-,n-p---fv-
τοξοδάμαντές	n-p---mn-	a-p---mn-,a-p---mv-
Μάρδων	n-s---mn-	n-p---mg-
Ἀσιῆτις	a-s---fn-	n-s---fn-,n-s---fn-
δουρικλύτοις	n-p---md-	a-p---md-,a-p---fd-,a-p---nd-
δράσι	n-p---md-	n-s---fd-
δολόμητιν	a-s---fa-	n-s---ma-
πήδη-	---------	v2spma---,v2spma---,v3siia---
θὴς	a-s---mn-	n-s---mn-
σᾶν	n-s---fg-	a-p---mg-,a-p---fg-
φραστός	a-s---fn-	a-s---mn-
εὐείμονε	a-d---fn-	a-d----n-,a-d----v-,a-d----a-
αὐτὼ	a-d---fa-	p-d---nn-,p-d---nv-,p-d---na-,p-d---mn-,p-d---mv-,p-d---ma-
θυμόμαντις	a-s---mn-	n-s---fn-
οὔτινος	a-s---mg-	p-s----g-
Ἀσίδος	a-s---fg-	n-s---fg-
δᾴ	---------	n-s---fd-,n-s---fv-
ἀφήλατο	v3saia---	v3saim---,v3saim---
Βακτρίων	n-p---mg-	a-p---fg-,a-p---mg-,a-p---ng-,n-p---ng-
Χρυσεὺς	a-s---mn-	n-s---mn-
Ἀρτάβης	n-s---mn-	n-s---fg-
ἐπανθορόντες	v-papa-n-	v-papamn-,v-papamv-
ξυνεμβολῇ	n-s---fd-	v2spse---,v2spie---,v3spsa---,v2spse---,v2spie---,v3spsa---
ἀλλήλοισιν	a-p---md-	p-p---nd-,p-p---md-
θείς	v-sappmn-	v-sapamn-,v-sapamv-
αἶ̓	n-s---fn-	c--------
ἔσκεν	v3sii----	v3siia---
βαλήν	n-s---mv-	n-s---mn-
φάσθαι	v--pn----	v--pnm---
μονάδα	a-s---ma-	n-s---fa-
τοῦπερ	p-s---mg-	l-s---mg-,l-s---ng-,x-s----g-,p-s----g-
πελά	---------	a-p---nn-,a-p---nv-,a-p---na-,a-d---fn-,a-d---fv-,a-d---fa-,a-s---fn-,a-s---fv-
ᾁδοβάται	a-p---mn-	n-p---mn-,n-p---mv-,n-s---md-
ταρφύς	a-s---fn-	a-s---mn-,a-s---mn-
οἰοῖ	i--------	v3spoa---,v2spie---
Σούσας	n-s---mn-	n-p---fa-,n-s---fg-,a-p---fa-,a-s---fg-,v-pppafa-,v-sppafg-
Ψάμμις	n-s---mn-	n-p---fa-,n-s---fn-
Σαλαμινιάσι	a-p---fd-	n-p---fd-
Μέμφις	n-s---mn-	n-p---fa-,n-s---fn-,n-s---fn-
Σησάμα	n-s---mg-	n-d---fn-,n-d---fv-,n-d---fa-,n-s---fn-,n-s---fv-
Ἀγχάρην	n-s---ma-	v3paip---,v1saip---
τοίπερ	p-p---mn-	l-p---mn-,p2s----d-,p2s----d-,g--------
κατεῖ-	---------	v2spia---
οἷμον	n-s---ma-	n-s---fa-
δέρκεσθαι	v--pne---	v--pnm---
εἰσιδούσᾳ	v-s-pafd-	v-sapafd-,v-sppafd-
νεκροδέγμονος	a-s---mg-	a-s----g-
Ταρτάρου	n-s---mg-	n-s---fg-,v3siia---,v2spma---,v2spma---,v3siia---
προδέρκεσθαι	v--pne---	v--pnm---
ἀγείτονος	a-s---mg-	a-s----g-
δέρκου	v2spme---	v2spmm---,v2siim---
τραχεῖς	a-p---ma-	a-p---mn-
στονόεν	a-s---na-	a-s---mv-,a-s---nn-,a-s---nv-
ὕπαρ	n-s---na-	x-----n--
εὔελπίς	a-s---mn-	n-s----n-
ποτινισομένα	v--ppefn-	v-dapmfn-,v-dapmfv-,v-dapmfa-,v-sapmfn-,v-sapmfv-,v-dfpmfn-,v-dfpmfv-,v-dfpmfa-,v-sfpmfn-,v-sfpmfv-
δερκομένα	v-sppefn-	v-dppmfn-,v-dppmfv-,v-dppmfa-,v-sppmfn-,v-sppmfv-
ἄκικυν	a-s---fa-	n-s---ma-,n-s---fa-
ὁμοπάτριον	a-s---fa-	a-s---ma-,a-s---nn-,a-s---nv-,a-s---na-
ἓ	i--------	p-s---ma-,p-s---fa-,p-s---ma-,p-s---fa-
ἕ	i--------	p-s---ma-,p-s---fa-,p-s---ma-,p-s---fa-
Ἰοῖ	n-s---fv-	v2spie---,v2spie---,v3spoa---,v3spia---
εἰσιδοῦσα	---------	v-sapafn-,v-sapafv-,v-sppafn-,v-sppafv-
ἐπίσχες	v2sama---	v2spia---,v2saia---
αὗταί	a-p---fn-	p-p---fn-,p-p---fv-
κενοφρόνων	a-p---ng-	a-p----g-
ἄλλαισιν	a-p---fd-	p-p---fd-
μονόδοντες	a-p---fn-	n-p---mn-,n-p---fn-,n-p---mv-,n-p---fv-
Βιβλίνων	a-p---ng-	n-p---mg-
Θεσπρωτοῦ	a-s---mg-	n-s---mg-
δέρκεται	v3spie---	v3spim---
εὐνά	---------	n-d---fn-,n-d---fv-,n-d---fa-,n-s---fn-,n-s---fv-
κρεισσόνων	a-p---mgc	a-p----gc
καθήσθω	v3spme---	v3spmm---
ἐκθοινήσεται	v3sfim---	v3sase---,v3sasm---
ἰδία	a-p---na-	a-d---fn-,a-d---fv-,a-d---fa-,a-s---fn-,a-s---fv-
ἀκροᾶσθαι	v--pne---	v--pnm---,v--fne---
ἀκροωμένων	v-pppemg-	v-pppmfg-,v-pppmmg-,v-pppmng-,v-pfpefg-,v-pfpemg-,v-pfpeng-
ἰαλτὸς	a-s---fn-	a-s---mn-
ὀρθόθριξ	n-s---mn-	a-s---mn-,a-s---fn-,a-s---mv-,a-s---fv-
φοβοῦ-	---------	v2spme---,v2siie---
πάνοιζυς	a-s---fn-	a-s---mn-
φοβεῖ-	v3spie---	v2spie---,v3spia---
παναρκέτας	a-s---fg-	n-p---ma-,n-s---mn-
δούλιόν	a-s---fa-	a-s---ma-,a-s---nn-,a-s---nv-,a-s---na-
ἅπλῶς	d--------	v2siia---,v2siia---
προσείδεται	v3spie---	v3spim---
δυσφρόνων	a-p---mg-	a-p----g-
φάμενος	v-sppemn-	v-sppmmn-
ὑπερβορέου	a-s---fg-	n-s---mg-
ὠμόφρων	a-s---mn-	n-s---mn-,n-s---fn-,n-s---mv-,n-s---fv-
σπαργάνοισι	n-s---nd-	n-p---nd-
οὕφις	n-s---fn-	n-p---ma-,n-s---mn-
ἐκδρακοντωθεὶς	v-sapamn-	v-sapemn-,v-sapemv-,v-sappmn-,v-sappmv-
Παρνησσίδα	a-s---fa-	n-s---fa-
κἀκεῖνον	a-s---ma-	p-s---ma-
ἀπέρω	---------	v2spme---
μὰς	a-s---fn-	n-p---ma-,n-s---mn-
Θεστιὰς	a-s---fn-	n-s---fn-
μήσατο	v3sai----	v3saim---
πυρδαῆτιν	a-s---fa-	n-s---fa-
ἐπεικότως	---------	d--------
νικήσει	v3sfia---	v3sasa---
εὐδαίμοσιν	a-p---md-	a-p----d-
ὀπισθόπους	n-p---ma-	a-s---mn-,a-s---fn-,a-s---mv-,a-s---fv-
Πειθὼ	n-s---fa-	n-s---fn-,n-s---fn-,a-d---mn-,a-d---nn-,a-d---mv-,a-d---nv-,a-d---ma-,a-d---na-
θετοσκυθρωπῶν	a-p---ng-	v-sppamn-
δίψη	n-s---fn-	n-p---nn-,n-p---nv-,n-p---na-,n-d---nn-,n-d---nv-,n-d---na-,v2spma---,v3siia---
κτίμενον	v-srpena-	a-s---ma-,a-s---nn-,a-s---nv-,a-s---na-
σὲ]	p-s---ma-	a-s---mv-,p2s----a-,p2s----a-
πρόπρας	---------	v2siia---
γυναικείους	a-p---fa-	a-p---ma-
ἐρρύσατο	v3sai----	v3saim---,v3slie---
ἱέμενός	v-spp-mn-	v-sppmmn-
ὄλοντο	v3pai----	v3paim---
λιλαιομένη	v-spp-fn-	v-sppmfn-,v-sppmfv-
περιπλομένων	v-ppp-mg-	v-pppmfg-,v-pppmmg-,v-pppmng-
ἐπεκλώσαντο	v3pai----	v3paim---
δυσομένου	v-sfp-mg-	v-sfpmmg-,v-sfpmng-
παρήμενος	v-sppemn-	v-srpmmn-
μνήσατο	v3sai----	v3saim---
ἔσσεται	v3sfi----	v3spie---,v3sfim---
γλαυκῶπις	a-s---fn-	n-s---fn-
ὀλοόφρονος	a-s---mg-	n-s---mg-,n-s---fg-
ἱέμενος	v-spp-mn-	v-sppmmn-
ὠδύσαο	v2sai----	v2saim---
Φόρκυνος	n-s---mg-	n-s---fg-
δυνήσεται	v3sfi----	v3sasm---,v3sfim---
μακάρεσσι	a-p---md-	n-p---md-,n-p---fd-
πολύφρονα	a-s---ma-	n-s---ma-,n-s---fa-
ὅνδε	d--------	d-s---ma-
ἐγὼν	p-s---fn-	p1s---mn-,p1s---fn-,p1s---mv-,p1s---fv-
ἐσελεύσομαι	v1sfi----	v1sfim---
φρεσὶ	n-p----d-	n-p---fd-
εἰλίποδας	n-p---ma-	a-p---ma-,a-p---fa-
ἐδήσατο	v3sai----	v3saie---,v3saim---,v3saim---
τοῖσίν	l--------	l-p---md-,l-p---nd-,x-p----d-
εἰδομένη	v-spp-fn-	v-sppmfn-,v-sppmfv-
δατεῦντο	v3pii----	v3piim---
μεθήμενος	---------	v-srpmmn-
ἐδέξατο	v3sai----	v3saim---,v3saim---
ἄμμι	p-p---md-	p1p---md-,p1p---fd-
φιλήσεαι	v2sfi----	v2sasm---,v2sfim---
πασσάμενος	v-sap-mn-	v-sapmmn-
θέτο	v3sai----	v3saim---
ἔροιτο	v3sao----	v3saom---
ἀγήνορες	a-p---mn-	n-p---mn-,n-p---fn-,n-p---mv-,n-p---fv-
ἐπεστέψαντο	v3pai----	v3paim---
ἕντο	v3pai----	v3paim---
γλαυκῶπιν	a-s---fa-	n-s---fa-
νεμεσήσεαι	v2sfi----	v2sasm---
ὅττι	p-s---na-	c--------
ἰδοίατο	v3pao----	v3paom---,v3ppoe---
ἐλεύσεσθαι	v--fn----	v--fnm---
ἀφίκεο	v2sai----	v2samm---,v2saim---,v2saim---
οἴνοπα	a-s---ma-	n-s---ma-
αἴθωνα	a-s---ma-	n-p---nn-,n-p---nv-,n-p---na-,n-s---ma-,n-s---fa-
αὐτοῖο	a-s---mg-	p-s---ng-,p-s---mg-
γένετο	v3sai----	v3saim---
νεμεσσήσαιτό	v3sao----	v3saom---
ἐβόλοντο	v3pii----	v3piim---
ἀκαχοίμην	v1sao----	v1saom---
ἀνηρείψαντο	v3pai----	v3paim---
Δουλιχίῳ	---------	n-s---md-
ἀποτίσεται	v3sfi----	v3sasm---,v3sfim---
ἀπώσεαι	v2sfi----	v2sasm---,v2sfim---
ὑποθήσομαι	v1sfi----	v1sasm---,v1sfim---,v1stie---,v1sfim---
πευσόμενος	v-sfp-mn-	v-sfpmmn-
χαλκοχιτώνων	a-p---mg-	n-p---mg-,n-p---fg-
κτερεΐξαι	v--ana---	v3saoa---
κατελεύσομαι	v1sfi----	v1sfim---
λήσομαι	v1sfi----	v1sasm---,v1sfim---
λοεσσάμενός	v-sap-mn-	v-sapmmn-
τεταρπόμενός	v-sap-mn-	v-sapmmn-
τιμῆεν	a-s---na-	a-s---nn-,a-s---mv-,a-s---nn-,a-s---nv-
λιλαιόμενόν	v-spp-ma-	v-sppmma-,v-sppmnn-,v-sppmnv-,v-sppmna-
διέπτατο	v3sai----	v3saim---
ὀίσατο	v3sai----	v3saim---,v3saim---,v3saim---
ἐπετείλατο	v3sai----	v3saim---
σύνθετο	v3sai----	v3saim---
περίφρων	a-s---fn-	n-s---mn-,n-s---fn-,n-s---mv-,n-s---fv-,n-s---mv-,n-s---fv-
κατεβήσετο	v3sai----	v3saim---
ἀμφίπολοι	n-p---fn-	a-p---mn-,a-p---fn-,a-p---mv-,a-p---fv-
ἄντα	r--------	d--------,n-d---fn-,n-d---fv-,n-d---fa-,n-s---fn-,n-s---fv-,v3siia---,v2spma---,v3siia---
σχομένη	v-sap-fn-	v-sapmfn-,v-sapmfv-
ἀμφιπόλοισι	n-p---fd-	a-p---md-,a-p---fd-,a-p---nd-
ἔνθετο	v3sai----	v3saim---
ἠρήσαντο	v3pai----	v3paim---,v3paie---,v3paie---,v3paie---,v3paim---
ὕμιν	p-p----d-	p2p----d-
ἐπιβώσομαι	v1sfi----	v1sasm---,v1sfim---
ὄλοισθε	v2pao----	v2paom---
ἀρέσθαι	v--an----	v--anm---
ἐξερέηται	v3sps----	v3spsm---,v3spse---,v3spse---
φάτο	v3sai----	v3siie---,v3saim---
ἕσπερον	n-s---ma-	a-s---ma-,a-s---fa-,a-s---nn-,a-s---nv-,a-s---na-
ἕσπερος	n-s---mn-	a-s---mn-,a-s---fn-
Ὦπος	n-s---mg-	n-s---fg-
πρίατο	v3sii----	v3siim---
πρωθήβην	a-s---fa-	n-s---ma-
μεγαλήτορος	a-s---mg-	n-s---mg-,n-s---fg-
προβλῆτες	a-p---fn-	n-p---mn-,n-p---fn-,n-p---mv-,n-p---fv-
ἀλλήλῃσιν	a-p---fd-	p-p---fd-
σχέθον	v1-iia---	v3paia---,v1saia---
ἀνήιον	v1siia---	v3piia---
πυθοίμην	v1sao----	v1spop---,v1saom---
αἴθοπα	a-s---ma-	n-s---ma-,n-s---fa-
ὁρώμενοι	v-ppp-mn-	v-pppmmn-,v-pppmmv-,v-pppemn-,v-pppemv-
ἐυκνήμιδας	a-p---ma-	n-p---fa-,n-p---ma-
ἄμμε	p-p---ma-	a-s---mv-,n-s---fv-,p1p---ma-,p1p---fa-
κρατερώνυχες	a-p---mn-	n-p---mn-,n-p---fn-,n-p---mv-,n-p---fv-
χαμαιευνάδες	---------	n-p---fn-,n-p---fv-,n-p---fn-,n-p---fv-
ἐκφάσθαι	v--pn----	v--pnm---
χρυσόρραπις	a-s---mn-	n-s---mn-,n-s---fn-
ὁππότε	c--------	d--------
σῦς	n-p---ma-	n-s---mn-,n-s---fn-
ταί	p-p---fn-	l-p---fn-
τάων	p-p---fg-	l-p---mg-,l-p---fg-
τρίποδι	n-s---md-	a-s---md-,a-s---fd-,a-s---nd-
τρίποδος	n-s---mg-	a-s---mg-,a-s---fg-,a-s---ng-
ἥμενον	v-srpema-	v-srpmma-,v-srpmnn-,v-srpmnv-,v-srpmna-
πρόφρασσα	a-s---fn-	v1saia---,v1saia---
ἐρίηρας	a-p---ma-	n-p---ma-,n-p---fa-
ἀγήνωρ	a-s---mn-	n-s---mn-,n-s---fn-
φάμενοι	v-ppp-mn-	v-pppmmn-,v-pppmmv-
ἐσάντα	d--------	v3siia---,v2spma---,v3siia---
ἔσσυται	v3spie---	v3spim---
κέλσαι	v2sam----	v2samm---,v--ana---,v3saoa---
βαθυδίνῃ	a-s---md-	n-s---md-
ὀρύξαι	v--ana---	v3saoa---
θῆλύν	a-s---fa-	a-s---ma-
ἕσσεν	v3-aia---	v--fna---,v3saia---
χαρίεν	a-s---na-	a-s---mv-,a-s---nn-,a-s---nv-
Ἄϊδόσδε	---------	d--------
φάσθε	v2piia---	v2ppmm---
ἧμιν	p-p---md-	p1p---md-,p1p---fd-
κατόπισθε	r--------	d--------
καταδέρκεται	v3spie---	v3spim---
ἐμεῖο	p-s---mg-	p1s---mg-,p1s---fg-,v2spoe---
ἐσσομένοισι	v-pfp-md-	v-pppemd-,v-pppend-,v-pfpmmd-,v-pfpmnd-
ἄνευθεν	d--------	r--------
συμβλήμενος	v-sap-mn-	v-sapmmn-
ἔσσονται	v3pfi----	v3ppie---,v3pfim---
ἧσται	v3sri----	v3srim---
φαμένη	v-sppefn-	v-sppmfn-,v-sppmfv-
χρησόμενον	v-sfp-ma-	v-sfpmma-,v-sfpmnn-,v-sfpmnv-,v-sfpmna-
λιλαίεο	v2spme---	v2spmm---,v2siim---
Τυρὼ	n-s---fa-	n-s---fn-,n-d---mn-,n-d---mv-,n-d---ma-
εὐπατέρειαν	a-s---fa-	n-s---fa-
οὔρεϊ	n-s---nd-	n-d----n-,n-d----v-,n-d----a-,n-s----d-,n-s----d-,v2spma---,v3siia---
περιπλομένου	v-spp-mg-	v-sppmmg-,v-sppmng-
Νηλῆα	n-s---ma-	n-s---fa-
θυμολέοντα	a-s---ma-	n-s---ma-
Ἰφικληείης	a-s---fg-	n-s---fg-
ἀγροιῶται	a-p---mn-	n-p---mn-,n-p---mv-
Ἰφικληείη	a-s---fg-	n-s---fn-,n-s---fv-
εἴσιδον	v1siia---	v3paia---,v1saia---
πολυάικος	a-s---mg-	n-s---mg-,n-s---fg-
ὔμμιν	p-p----d-	p2p----d-
πολύμητις	a-s---mn-	n-s---mn-,n-s---fn-
ἀνασχοίμην	v1sao----	v1saom---
λιλαίεαι	v2spie---	v2spim---
ἀπόλοντο	v3pai----	v3paim---
μαχεούμενον	v-sppema-	v-sppmma-,v-sppmnn-,v-sppmnv-,v-sppmna-
ἀργιόδοντες	a-p---mn-	n-p---mn-,n-p---fn-,n-p---mv-,n-p---fv-
δολόμητις	a-s---fn-	n-s---mn-
ἐσσομένῃσιν	v-pfp-fd-	v-pppefd-,v-pfpmfd-
εὐρύοπα	a-s---mn-	n-s---mn-,n-s---mv-,n-s---ma-
Πηληϊάδεω	---------	n-s---mg-
σεῖο	p-s----g-	v2spoe---,p2s----g-
νόσφιν	d--------	r--------
Πηληϊάδαο	---------	n-s---mg-
φθιμένοιο	v-sap-mg-	v-sapmmg-,v-sapmng-
τεῒν	p-s----d-	p2s----d-,g--------
ἀγήνορα	a-s---ma-	n-s---ma-,n-s---fa-
παρημένω	v-dppamn-	v-drpmmn-,v-drpmnn-,v-drpmmv-,v-drpmnv-,v-drpmma-,v-drpmna-,v-srpmmg-,v-srpmng-
εἰσεῖδον	v1siia---	v3paia---,v1saia---
διψάων	v-spp-mn-	n-p---fg-
ἀναβροχέν	v-sapann-	v-sappnn-,v-sappnv-,v-sappna-
ἠριγενείης	a-s---fg-	n-s---fg-
ἐντυναμένη	v-sppefn-	v-sapmfn-,v-sapmfv-,v-sapmfn-,v-sapmfv-
ἀπονόσφιν	r--------	d--------
προσέλεκτο	v3saie---	v3saip---
γάνυνται	v3ppie---	v3ppim---
ἥμεναι	v-prp-fn-	v-prpmfn-,v-prpmfv-
κυανώπιδος	a-s---fg-	n-s---fg-
τρήρωνες	a-p---fn-	n-p---mn-,n-p---fn-,n-p---mv-,n-p---fv-
λὶς	a-s---fn-	n-s---mn-,n-s---fn-
λίς	a-s---f--	n-s---mn-,n-s---fn-
κρατὶ	n-s---nd-	n-s---fd-
ἐγών	p-s---mn-	p1s---mn-,p1s---fn-,p1s---mv-,p1s---fv-
κῆρα	n-s---ma-	n-s---fa-
νηνεμίη	a-s---fn-	n-s---fn-,n-s---fv-
ἔντυνον	v3paia---	v2sama---,v3piia---,v1siia---,v2sama---,v3piia---,v1siia---
ὄπ	n-s---fa-	i--------
πλείοσί	a-p---mdc	a-p----dc,a-p---ndc
σπῆι	n-s---nd-	v2sase---,v3sasa---,v2spse---,v2spie---,v3spsa---,v3spia---
ῥηγμῖνα	n-s---fa-	n-s---ma-
ὕπερθεν	d--------	r--------
κεῖνο	a-s---na-	p-s---nn-,p-s---nv-,p-s---na-
Αἰαίης	a-s---fg-	n-s---fg-
ἄμμιν	p-p---md-	p1p---md-,p1p---fd-
ἔφαγε	v3siia---	v3saia---
λιλαιόμενοι	v-pppemn-	v-pppmmn-,v-pppmmv-
δρεψάμενοι	v-pap-mn-	v-papmmn-,v-papmmv-
ἐξέσσυτο	v3siie---	v3siim---
ἔκταμεν	v1paia---	v3saia---
ἀποαίνυτο	v3siie---	v3siim---
κατεσκίαον	v3paia---	v3piia---
ὑμέων	p-p----g-	p2p----g-,a-p---mg-,a-p---fg-
ἐφιέμενος	v-sppemn-	v-sppmmn-
ἀκουάζεσθε	v2ppie---	v2piim---,v2ppmm---,v2ppim---,v2piim---
εὐήνορα	a-s---ma-	n-p---nn-,n-p---nv-,n-p---na-,n-s---ma-,n-s---fa-
λιλαίεται	v3spie---	v3spim---
βόε	n-d----n-	n-d---mn-,n-d---fn-,n-d---mv-,n-d---fv-,n-d---ma-,n-d---fa-
βλάβεται	v3spie---	v3spim---
προσεπίλνατο	v3siie---	v3siim---
ἀπορρῶγες	a-p---fn-	n-p---mn-,n-p---fn-,n-p---mv-,n-p---fv-
ἔσομαι	v1sfi----	v1sfim---
ὑπέσχεο	v2saia---	v2saim---,v2saim---
κάτθεσαν	v3saia---	v3paia---
προὐφαίνετο	v3s-ie---	v3siie---,v3siie---
τίνυται	v3spie---	v3spim---
σάω	v2spme---	v2spma---,v3siia---,v3siia---,v2spmm---,a-d---mn-,a-d---nn-,a-d---mv-,a-d---nv-,a-d---ma-,a-d---na-,a-s---mg-,a-s---ng-
τηλοῦ	r--------	d--------
πολύτλας	---------	n-p---ma-,n-s---mn-,n-s---mn-
Τρωϊάδος	---------	n-s---fg-
ἀλαλήμενος	v-spp-mn-	v-srpmmn-,v-sppmmn-,v-srpemn-,v-sppemn-
Νήριτόν	n-s---nn-	n-s---ma-,a-s---ma-,a-s---fa-,a-s---nn-,a-s---nv-,a-s---na-
παρήμενον	v-sppema-	v-srpmma-,v-srpmnn-,v-srpmnv-,v-srpmna-
καλλιγύναικα	a-s---fa-	n-s---ma-,n-s---fa-
τώ	p-d---mn-	l-d---fn-,l-d---fv-,l-d---fa-,l-d---ma-,l-d---na-,l-d---mn-,l-d---nn-,l-d---mv-,l-d---nv-,l-d---ma-,l-d---na-,d--------
κερδοσύνη	n-s---fd-	n-s---fn-,n-s---fv-
ἧμαι	v1spie---	v1srim---,v1spim---
ἰονθάδος	a-s---fg-	n-s---fg-
πτωχοί	n-p---mn-	a-p---mn-,a-p---mv-,a-p---mn-,a-p---fn-,a-p---mv-,a-p---fv-
τοσσοῦτον	a-s---nn-	p-s---ma-
δεξαμένη	v-sap-fn-	v-sapmfn-,v-sapmfv-,v-sapmfn-,v-sapmfv-
αἴνυται	v3spie---	v3spim---
ἀναίνεαι	v2spie---	v2spim---
νῶϊν	p-d---md-	p1d---mg-,p1d---fg-,p1d---md-,p1d---fd-
ἄλλοισίν	a-p---nd-	p-p---nd-,p-p---md-
ἔκτοσε	r--------	d--------
Δουλίχιον	n-s---na-	n-s---ma-
παρήμενοι	v-ppp-mn-	v-prpmmn-,v-prpmmv-
ἀργιοδόντων	a-p---mg-	n-p---mg-,n-p---fg-
ἀργιόδοντος	a-s---mg-	n-s---mg-,n-s---fg-
αἰειγενέτῃσι	a-p---md-	n-p---md-,n-p---md-
πηγυλίς	a-s---fn-	n-s---fn-
φάγωσι	v3ppsa---	v3pasa---,n-p---md-
καλλικόμοιο	---------	n-s---mg-,n-s---fg-
ἱέμενον	v-sppema-	v-sppmma-,v-sppmnn-,v-sppmnv-,v-sppmna-
ἐσσύμενον	v-sppema-	a-s---ma-,a-s---nn-,a-s---nv-,a-s---na-,v-srpmma-,v-srpmnn-,v-srpmnv-,v-srpmna-,v-sppmma-,v-sppmnn-,v-sppmnv-,v-sppmna-,v-srpema-,v-srpenn-,v-srpenv-,v-srpena-
τριπόδων	n-p---mg-	a-p---mg-,a-p---fg-,a-p---ng-
Βοηθοΐδης	---------	n-s---mn-
ἐξαίνυτο	v3siie---	v3siim---
καλλίτριχας	n-p---ma-	a-p---ma-,a-p---fa-
Μελάμποδος	n-s---mg-	a-s---mg-,a-s---mg-
Νηλέα	n-s---ma-	n-s---fa-,a-p---nn-,a-p---nv-,a-p---na-,a-s---ma-,a-s---fa-
Νηλῆος	n-s---mg-	n-s---fg-
δασπλῆτις	a-s---fn-	n-s---fn-
λιλαίομαι	v1spie---	v1spim---
ἀνδρὼν	n-p---mg-	n-s---mn-,n-s---mv-
δέδασται	v3srie---	v3srim---
τῇσιν	p-p---fd-	l-p---fd-
πῆ	p--------	g--------,n--------
τεῦ	x--------	p2s----g-,x-s----g-,p-s----g-
μεσσηγὺς	r--------	d--------
συναντόμενος	v-spp-mn-	v-sppmmn-
ἄττα	n-s---mv-	i--------
ὑποδέξομαι	v1sas----	v1sasm---,v1sfim---,v1sasm---,v1sfim---
πλεόνεσσιν	a-p---md-	a-p----dc
ὑποδάμνασαι	v2spie---	v2samm---
ὄρηται	v3sas----	v3sasm---,v3sasm---,v3spse---
μίν	p-s---ma-	p3s---ma-,p3s---fa-,p3s---na-
φάο	v2spme---	v2spmm---
σφῶϊν	p-d----g-	p-p---mg-,p-p---fg-,p2d----g-,p2d----d-,p2d----g-,p2d----d-
ἕσσο	v2slim---	v3slip---
γαμψώνυχες	---------	n-p---mn-,n-p---fn-,n-p---mv-,n-p---fv-
ἐπίφρονα	a-s---fa-	n-s---ma-
δοιὼ	a-d---mn-	d--------
καθημένω	v-drpemn-	v-drpmmn-,v-drpmnn-,v-drpmmv-,v-drpmnv-,v-drpmma-,v-drpmna-,v-srpmmg-,v-srpmng-
ἔσεσθον	v2dfi----	v3dfim---,v2dfim---,v2daim---
παρφάσθαι	v--pne---	v--pnm---
ἧμας	p-p---ma-	p1p---ma-,p1p---fa-
ἀπομηνίσει	v3sfia---	v3sasa---
βόλεσθε	v2ppie---	v2ppmm---,v2ppim---,v2piim---
Δουλιχίου	n-s---ng-	n-s---mg-
ἔσχεθεν	v3siia---	v3saia---
ἱεμένους	v-pppema-	v-pppmma-
ἐμέθεν	p-s---mg-	p1s---mg-,p1s---fg-,v3paia---
δερκομένοιο	v-sppemg-	v-sppmmg-,v-sppmng-
ἀλέασθαι	v--an----	v--anm---
παλάμηφιν	n-p---fd-	n-----fg-
προβιβάς	v-sapamn-	v-sppamn-,v-sppamv-
καστορνῦσα	v-sapafn-	v-sppafn-,v-sppafv-
ἀνάλκιδες	a-p---mn-	n-p---fn-,n-p---fv-
χέρειον	a-s---nn-	n-s---mv-,n-s---fv-
ῥίγιον	a-s---nnc	d--------,v3piia---,v1siia---
πτωχὸν	n-s---ma-	a-s---ma-,a-s---nn-,a-s---nv-,a-s---na-,a-s---ma-,a-s---fa-,a-s---nn-,a-s---nv-,a-s---na-
προπάροιθεν	d--------	r--------
τραπεζῆες	---------	n-p---mn-,n-p---mv-
ἀποαίνυται	v3spie---	v3spim---
δεδειπνήκειν	v3slia---	v--rna---,v1slia---
πτωχοὶ	n-p---mn-	a-p---mn-,a-p---mv-,a-p---mn-,a-p---fn-,a-p---mv-,a-p---fv-
θρῆνυν	n-s---ma-	n-s---fa-
ἀπάνευθε	r--------	d--------
πτωχῶν	n-p---mg-	a-p---fg-,a-p---mg-,a-p---ng-,a-p---mg-,a-p---fg-,a-p---ng-
ἡμένη	v-srpefn-	v-srpmfn-,v-srpmfv-
ποτιδέρκεται	v3spie---	v3spim---
κῆρας	n-p---ma-	n-p---fa-
ἀσσοτέρω	d--------	d-------c
ἐπιλλίζουσιν	v3ppie---	v-pppamd-,v-pppand-,v3ppia---,v-pppamd-,v-pppand-,v3ppia---,v-pppamd-,v-pppand-,v3ppia---
προκαλίζεο	v2spma---	v2spme---,v2spme---,v2siie---,v2siie---
ζῶσαι	v2sam----	v-pppafn-,v-pppafv-,v2samm---,v--ana---
τοῖϊν	p-d---mg-	l-d---mg-,l-d---ng-,l-d---md-,l-d---nd-
ἀλλήλοιϊν	a-d---md-	p-d----g-,p-d----d-,p-d---ng-,p-d---nd-,p-d---mg-,p-d---md-
κατθέμεθα	v1pai----	v1paim---
μαχήσεται	v3sfi----	v3sfim---,v3sasm---,v3sfim---,v3sasm---,v3sfim---
ζώσατο	v3sai----	v3saim---
τοῦτόν	a-s---ma-	p-s---ma-
ἀνασχόμενοι	v-pap-mn-	v-papmmn-,v-papmmv-
γέλῳ	a-s---md-	n-s---md-,n-s---fd-,n-p---mn-,n-s---md-
ἧσο	v2srme---	v2srmm---,v2slim---,v2siim---
πολέεσσι	a-p---nd-	n-p---fd-,n-p----d-,a-p---md-
ἀπεχθομένοισί	v-papamd-	v-pppemd-,v-pppend-,v-papmmd-,v-papmnd-
Ἴασον	a-s---na-	n-s---ma-,n-s---mv-,v2sama---
ἐϋκνήμιδας	a-p---ma-	n-p---fa-,n-p---ma-
ὠκυπόδων	n-p---fg-	a-p---mg-,a-p---fg-,a-p---ng-
ἀνέσει	v3sfia---	n-d---fn-,n-d---fv-,n-d---fa-,n-s---fd-,n-s---fd-
ἀλλήλας	a-p---fa-	p-p---fa-
γέλω	n-s---ma-	n-s----d-,n-s---md-,n-s---mg-
χερείονα	n-p---nn-	n-s---ma-,n-s---fa-
Δουλιχιεύς	a-s---mn-	n-s---mn-
Κνωσός	n-s---mn-	n-s---fn-
ἴσω	r--------	a-d---mn-,a-d---nn-,a-d---mv-,a-d---nv-,a-d---ma-,a-d---na-,a-s---mg-,a-s---ng-,a-d---mn-,a-d---nn-,a-d---mv-,a-d---nv-,a-d---ma-,a-d---na-,a-s---mg-,a-s---ng-,v3siia---,v2spma---,v3siia---
λάε	v3siia---	v2spma---,v2spma---
ἀλλάων	a-p---fg-	p-p---mg-,p-p---fg-
δὶα	r--------	a-d---fn-,a-d---fv-,a-d---fa-,a-s---fn-,a-s---fv-
ὀρώρεται	v3spie---	v3spim---
ἐνεχεύατο	v3sai----	v3saim---
ἀμφράσσαιτο	v3sao----	v3saom---
ὀδυσσάμενος	v-sap-mn-	v-sapmmn-
ἕπον	v3paia---	v3piia---,v1siia---
κραδάων	v-sppamn-	n-p---fg-
διάει	v3spia---	v2spia---,v2sfie---
ἐνέην	v3siia---	v1siia---,v3piia---,v1siia---
ἔσχεθον	-3paia---	v3paia---,v1saia---
ἄνευθε	d--------	r--------
ἑσσάμενος	v-sap-mn-	v-sapmmn-,v-sapmmn-
ὀνήμενος	v-sap-mn-	v-sapmmn-
ἐεδνώσαιτο	v3sao----	v3saom---
νεμεσσήθητε	v2pamp---	v2paip---
αἰδέσθητε	v2pamp---	v2paip---
ἀγασσάμενοι	v-pap-mn-	v-papmmn-,v-papmmv-,v-papmmn-,v-papmmv-
σχέσθε	v2pam----	v2pamm---,v2paim---
ἀποτινύμενοι	v-pppemn-	v-pppmmn-,v-pppmmv-
φάγοιτε	v2ppoa---	v2paoa---
στησαμένη	v-sap-fn-	v-sapmfn-,v-sapmfv-
παραθεῖτο	v3sao----	v3spoe---,v3spom---,v3siie---,v3saom---
ἐυπλοκαμῖδες	a-p---fn-	n-p---fn-,n-p---fv-
ἔδονται	v3pfi----	v3pfim---,v3ppie---,v3pfim---
Ἰκαρίῳ	n-s---md-	a-s---md-,a-s---nd-
παρφάμενος	v-spp-mn-	v-sppmmn-
ἀπεχθάνεαι	v2spia---	v2spim---
βεβρώσεται	v3sti----	v3stim---
κεχάροιτο	v3sao----	v3saom---
ὑπερηνορέοντες	a-p---mn-	n-p---mn-,n-p---mv-
ἔσσεαι	v2sfi----	v2spie---,v2sfim---
ἀπέσσεται	v3sfi----	v3sfim---
συλλέξομαι	v1sfi----	v1sasm---,v1sfim---
ἐπιόψομαι	v1sfi----	v1sasm---,v1sfim---
ἀνιεμένους	v-ppp-ma-	v-pppmma-
ὔμμι	p-p----d-	p2p----d-
πίειραν	a-s---fa-	n-s---fa-
ἀπόληται	v3sas----	v3sasm---
ἐκπροκαλεσσαμένη	v-sap-fn-	v-sapmfn-,v-sapmfv-
ἐυκνήμιδες	a-p---mn-	n-p---fn-,n-p---fv-,n-p---mn-,n-p---mv-
δησάμενοι	v-pap-mn-	v-papemn-,v-papemv-,v-papmmn-,v-papmmv-,v-papmmn-,v-papmmv-
στήσαντο	v3pai----	v3paim---
ταὶ	p-p---fn-	l-p---fn-
ἀλλήλῃσι	a-p---fd-	p-p---fd-
αὐτῇσιν	a-p---fd-	p-p---fd-
φάσθω	v3spm----	v3spmm---
ἀγρόμεναι	v-pap-fn-	v-papmfn-,v-papmfv-
ἀμφιμάσασθε	v2pama---	v2pamm---,v2paim---,v2paim---,v2pamm---,v2paim---,v2pamm---,v2paim---
πολυμήτις	a-s---mn-	n-p---ma-,n-p---fa-
μετέρεπον	-3piia---	v3piia---,v1siia---
ὑποσταχύοιτο	v3spoa---	v3spoe---
ὀμοῦμαι	v1sfi----	v1sfim---
τρήρωνα	a-s---fa-	n-s---ma-,n-s---fa-
σφωϊν	p-d---md-	p-p---mg-,p-p---fg-,p-p---mg-,p-p---fg-
ἱεμένων	v-ppp-ng-	v-pppmfg-,v-pppmmg-,v-pppmng-
ἔξειμι	v1sfia---	v1spia---,v1spia---
προσεδέρκετο	v3siie---	v3siim---
αἴνυτο	v3siie---	v3siim---
ἱέμενόν	v-sppema-	v-sppmma-,v-sppmnn-,v-sppmnv-,v-sppmna-
κεκαδήσει	v3sfia---	v2stie---
φθεγξάμενός	v-sap-mn-	v-sapmmn-
ἄξομαι	v1sfi----	v1sasm---,v1sfim---,v1sasm---,v1sfim---
εἰσιδέτην	v3dpia---	v3daia---
ὔμμες	p-p----n-	p2p----n-
ἄλλῃσιν	a-p---fd-	p-p---fd-
ἧφι	a-p---fd-	x-s---fd-
ὑμείων	p-p----g-	p2p----g-
ἀγκυλομήτεω	a-s---mg-	n-s---mg-,n-s---fg-
ἄμμες	p-p---mn-	p1p---mn-,p1p---fn-,p1p---mv-,p1p---fv-
ἐεικοσάβοιον	a-s---fa-	a-s---ma-,a-s---nn-,a-s---nv-,a-s---na-
μεσσηγύς	r--------	d--------
ποικιλομήτην	a-s---ma-	n-s---ma-
σφῶϊ	p-d----n-	v3sfoa---,a-s---md-,a-s---nd-,p2d----n-,p2d----a-
βεβλήκειν	v3slia---	v--rna---,v1slia---
διαπρὸ	d--------	r--------
ἀγκυλοχεῖλαι	a-p---mn-	n-p---mn-,n-p---mv-
λειώδης	n-s---mn-	a-p---ma-,a-p---fa-,a-p---mn-,a-p---fn-,a-p---mv-,a-p---fv-,a-s---mn-,a-s---fn-
ὑποκλοπέοιτο	v3spoa---	v3spoe---,v3spoe---
ἱεμένην	v-sppefa-	v-sppmfa-
συβώτῃς	n-s---mn-	n-p---md-
ἐσιέμεναι	v-pppefn-	v--pna---,v-pppmfn-,v-pppmfv-
αἰνύμεναι	v-pppefn-	v-pppmfn-,v-pppmfv-
εἴρυσθαι	v--pne---	v--pnm---
προσφάσθαι	v--pne---	v--pnm---
ἡγείσθω	v3spme---	v3spmm---
μεγαλήτορα	a-s---ma-	n-s---ma-,n-s---fa-
ὠκύποδας	n-p---ma-	a-p---ma-,a-p---fa-
ὑψιβρεμέτης	a-s---mn-	n-s---mn-
Καλυψώ	n-s---fa-	n-s---fn-
ἐέλπετο	v3siie---	v3siim---,v3siim---
ἀκάκητα	a-s---mn-	n-s---mv-,n-s---mn-
Πηλεΐδαο	n-s---ma-	n-s---mg-,n-s---mg-,n-s---mg-
ἀργυρόπεζα	a-s---fn-	n-s---fn-,n-s---fv-,a-p---nn-,a-p---nv-,a-p---na-
μαχεούμενοι	v-pppemn-	v-pppmmn-,v-pppmmv-
ἡμείων	p-p---mg-	p1p---mg-,p1p---fg-
νοός	n-s---mn-	n-s---mg-
ἐξερέοιτο	v3spo----	v3spom---,v3spoe---,v3spoe---,v3sfom---
ξεινήϊα	a-p---na-	n-p---nn-,n-p---nv-,n-p---na-
ἁπλοΐδας	a-p---fa-	n-p---fa-
Ἀλύβαντος	---------	n-s---mg-
τινύμενος	v-sppemn-	v-sppmmn-
τρισκαίδεκα	m--------	m-p---m--,m-p---f--
πολέας	a-p---ma-	a-p---nn-,a-p---nv-,a-p---na-
νώροπα	a-s---ma-	n-s---ma-,n-s---fa-
ἐφέψειν	v--fna---	v--pna---
μελίφρονος	a-s---mg-	n-s---mg-,n-s---fg-
γλαυκώπιδος	a-s---fg-	n-s---fg-
ὀβριμοπάτρης	a-s---fn-	n-s---fg-
κυανοχαίτῃ	a-s---md-	n-s---md-
ὑποθήσεται	v3sfi----	v3sasm---,v3sfim---,v3stie---,v3sfim---
εὔξεαι	v2sas----	v2sasm---,v2sfim---
ἀλάλησθε	v2ppi----	v2piim---,v2ppmm---,v2ppim---,v2piim---,v2piie---,v2ppme---,v2ppie---,v2plie---,v2prme---,v2prie---,v2piie---
πολέμιξον	v3paia---	v2sama---
ἐπίφρονι	a-s---fd-	n-s---md-
ἐξακέσαιτο	v3sao----	v3saom---
ὃδὴ	---------	v2spma---,v2spma---,v3siia---
κοὐδέ	---------	g--------,n-s---mv-,n-s---fv-
καταφθιμένοιο	v-sap-mg-	v-sapmmg-,v-sapmng-
τοσσήνδε	a-s---fa-	p-s---fa-
ἐκλελάθοιτο	v3sao----	v3saom---
ἀνάξασθαι	v--an----	v--anm---,v--anm---,v--anm---
ἀναίνετο	v3sii----	v3siim---,v3siim---
ἐφράσατο	v3sai----	v3saim---
ἀνάλκιδος	a-s---mg-	n-s---fg-
ἀλάλησο	v2spm----	v2siim---,v2spmm---,v2siim---,v2siie---,v2spme---,v2slie---,v2srme---,v2siie---
φάγωσιν	v3ppsa---	v3pasa---,n-p---md-
καταλέξεται	v3sfi----	v3sasm---,v3sfim---
ἕψεται	v3sfi----	v3sfim---,v3spie---
ἐυμμελίην	a-s---ma-	n-s---ma-
εἰργάξετο	v3sai----	v3saim---
προβάλοντο	v3pai----	v3paim---
Νηληϊάδαο	---------	n-s---mg-
αὐτώ	a-d---mn-	p-d---nn-,p-d---nv-,p-d---na-,p-d---mn-,p-d---mv-,p-d---ma-
διέσσυτο	v3siie---	v3siim---
ξύνετο	v3sai----	v3saim---
κεκράαντο	v3paim---	v3prie---
νῶιν	p-d---md-	p1d---mg-,p1d---fg-,p1d---md-,p1d---fd-
Θῶνος	n-s---mg-	n-s----g-
εὐρυάγυιαν	a-s---fa-	n-s---fa-
Δηΐφοβος	---------	n-s---mn-
Τυδεΐδης	---------	n-s---mn-
ἱεμένω	v-dppema-	v-sppmmg-,v-sppmng-,v-dppmmn-,v-dppmnn-,v-dppmmv-,v-dppmnv-,v-dppmma-,v-dppmna-
τέκμωρ	x--------	x-s---nn-,x-s---nv-,x-s---na-
φρικὶ	n-s---fd-	n-s---md-
νέποδες	n-p---mn-	a-p---mn-,a-p---mv-
ὀλοώτατος	a-s---fns	a-s---mns
συβώτη	n-s---md-	n-s---mv-,v2spma---,v3siia---
ὑγρήν	n-s---fa-	a-s---fa-
τῇς	p-p---fd-	l-p---fd-
ἐσσύμενός	v-sppemn-	a-s---mn-,v-srpmmn-,v-sppmmn-,v-srpemn-
βένθοσδε	d--------	d-----n--
ἐπέσσυτο	v3siie---	v3siim---
πολέεσσιν	a-p---nd-	n-p---fd-,n-p----d-,a-p---md-
τῇσίν	p-p---fd-	l-p---fd-
δερκέσκετο	v3siie---	v3siim---
ἠνώγειν	v3slia---	v1slia---
ἀγήρως	a-s---fn-	d--------,a-p---ma-,a-p---fa-,n-s---mg-,n-s---fg-,n-s---mn-,n-s---fn-
ᾔνυτο	v3siie---	v3siim---
ἐπεσσύμενον	v-sppenn-	v-srpmma-,v-srpmnn-,v-srpmnv-,v-srpmna-,v-sppmma-,v-sppmnn-,v-sppmnv-,v-sppmna-,v-srpema-,v-srpenn-,v-srpenv-,v-srpena-
καλλίσφυρος	a-s---fn-	n-s---mn-,n-s---fn-
πουλύποδος	n-s---mg-	a-s---mg-
παρέξ	d--------	r--------
ἐπαμήσατο	v3saim---	v3saie---
φέρτεροι	a-p---mnc	a-p---mn-,a-p---mv-
ἐπιπίλναται	v3spie---	v3spim---
ἀμφίς	r--------	d--------
βέλτερον	a-s---nnc	a-s---ma-,a-s---nn-,a-s---nv-,a-s---na-
καὐτή	a-s---fn-	p-s---fn-,p-s---fv-
ἐφήμενος	v-sppemn-	v-srpmmn-
Φαίηξιν	n-p---fd-	n-p---md-
ἔων	v-sppamn-	v3piia---,v1siia---
ἑκαστέρω	d--------	d-------c
ἀργιόδοντας	a-p---ma-	n-p---ma-,n-p---fa-
θαλείῃ	a-s---fd-	n-s---fd-
χρείων	v-sppamn-	n-p---ng-,a-p---mg-,a-p---fg-,a-p---ng-
Ἀναβησίνεώς	---------	n-p---ma-,n-s---mn-
προτέροισιν	a-p---mdc	a-p---md-,a-p---nd-
Οιχαλιῆι	a-s---md-	n-s---md-
ἀρτίπος	n-s---mn-	a-s---mn-,a-s---fn-,a-s---mv-,a-s---fv-
ἑάων	a-p---ng-	a-p---mg-,a-p---fg-
Δηιφόβοιο	---------	n-s---mg-,a-s---mg-,a-s---fg-,a-s---ng-
Δουλίχιόν	n-s---nn-	n-s---ma-
κουροτρόφος	n-s---fn-	a-s---mn-,a-s---fn-
Αἰαίη	a-s---fn-	n-s---fn-,n-s---fv-
μηκάδας	a-p---fa-	n-p---fa-
αἰνυμένους	v-pppema-	v-pppmma-
αἰνύμενοι	v-pppemn-	v-pppmmn-,v-pppmmv-
φάγομεν	v1piia---	v1paia---
αἰνυμένῳ	v-sppemd-	v-sppmmd-,v-sppmnd-
ἀνεσχέθομεν	v1piia---	v1paia---
ἐλέγμην	v1saip---	v3saip---
σύντρεις	d--------	v2siia---
αἰνύμενος	v-sppemn-	v-sppmmn-
ταναύποδα	n-p---na-	a-p---nn-,a-p---nv-,a-p---na-,a-s---ma-,a-s---fa-
ἄρκον	---------	n-s---ma-
Ἠλεκτρυώνης	a-s---fg-	n-s---fg-
Φίκιον	n-s---ma-	n-s---nn-,n-s---nv-,n-s---na-
χειρότερον	a-s---mac	a-s---ma-,a-s---nn-,a-s---nv-,a-s---na-,a-s---ma-,a-s---nn-,a-s---nv-,a-s---na-
Ἠλεκτρυώνῃ	a-s---fd-	n-s---fd-
ἐπιπλομένων	v-pppemg-	v-pppmfg-,v-pppmmg-,v-pppmng-
ἄαται	v3spie---	n-p---fn-,n-p---fv-,v3spim---
Ἀλκεΐδαο	---------	n-s---mg-
δερκομένη	v-sppefn-	v-sppmfn-,v-sppmfv-
δερκομένων	v-pppemg-	v-pppmfg-,v-pppmmg-,v-pppmng-
Πετραῖον	n-s---ma-	a-s---ma-,a-s---nn-,a-s---nv-,a-s---na-
Οὔρειόν	n-s---ma-	a-s---ma-,a-s---nn-,a-s---nv-,a-s---na-,a-s---ma-,a-s---fa-,a-s---nn-,a-s---nv-,a-s---na-,a-s---ma-,a-s---nn-,a-s---nv-,a-s---na-
ἱμερόεν	a-s---na-	a-s---mv-,a-s---nn-,a-s---nv-
δερκομένω	v-dppemn-	v-dppmmn-,v-dppmnn-,v-dppmmv-,v-dppmnv-,v-dppmma-,v-dppmna-,v-sppmmg-,v-sppmng-
πρεσβυτάτη	a-s---fns	a-s---fn-,a-s---fv-
λαγὸς	n-p---ma-	n-s---mn-
καρχαρόδοντε	a-d---mn-	n-d----n-,n-d----v-,n-d----a-,n-d---mn-,n-d---fn-,n-d---mv-,n-d---fv-,n-d---ma-,n-d---fa-
φέρτατε	a-s---mvs	a-s---mv-
ὀξεῖα	a-p---na-	a-s---fn-,a-s---fv-
ἀλλήλῃς	a-p---fd-	p-p---fd-
Ἰαωλκὸς	n-s---fn-	n-s---mn-
μεγαθαρσέι	a-s---md-	a-s----d-
χαυλιόδων	a-s---mn-	n-s----n-
ὠκυπόδεσσιν	n-p---md-	a-p---md-,a-p---fd-,a-p---nd-
Ἰαωλκὸν	n-s---fa-	n-s---ma-
Ὁ	p-s---mn-	l-s---mn-
βράδιον	d-------c	a-s---mvc,a-s---fvc,a-s---nnc,a-s---nvc,a-s---nac
ἀμύνῃ	n-s---fd-	v2sasm---,v3sasa---,v2spse---,v2spie---,v3spsa---
Διόπερ	d--------	c--------
Μὴ	d--------	c--------
ἐκαθέζετο	v3siie---	v3siim---
Τοῦ	p-s---mg-	l-s---mg-,l-s---ng-,x-s----g-,p-s----g-
Ἀλλὰ	c--------	d--------
Αἱ	p-p---fn-	l-p---fn-,l-p---fv-
ἄπειρα	d--------	a-p---nn-,a-p---nv-,a-p---na-,a-p---nn-,a-p---nv-,a-p---na-
ποιούσῃ	v3sasa---	v-sppafd-,v-sppafd-
ἐναλλόμενος	v-sppemn-	v-sppmmn-
Ἀτὰρ	d--------	g--------
βραχύτεροι	a-p---mnc	a-p---mn-,a-p---mv-
Τῆς	p-s---fg-	l-s---fg-
λινῷ	n-s---nd-	a-s---md-,a-s---nd-
λαβροῦ	a-s---ng-	v2spme---,v2siie---
Ποτὲ	d--------	g--------,a-s---mv-
Μιᾶς	m-s---fg-	a-s---fg-
ὁποία	p-s---fn-	a-d---fn-,a-d---fv-,a-d---fa-,a-s---fn-,a-s---fv-
ψύχην	n-s---fa-	v--pna---,v3paip---,v1saip---,n-s---na-
ὅσας	p-p---fa-	a-p---fa-,a-s---fg-
μικροῦ	d--------	a-s---mg-,a-s---ng-,a-s---mg-,a-s---ng-
ῥᾴδιον	d--------	a-s---ma-,a-s---nn-,a-s---nv-,a-s---na-,a-s---ma-,a-s---fa-,a-s---nn-,a-s---nv-,a-s---na-,n-s---nn-,n-s---nv-,n-s---na-
κεκράξεσθε	v2p-im---	v2ptim---
πότερόν	d--------	a-s---ma-,a-s---nn-,a-s---nv-,a-s---na-
ἐπιδείξαι	v--ana---	v3saoa---
ἀλαζονευόμενος	v-sppemn-	v-sppmmn-
Ὀλυμπιάδες	a-p---fn-	n-p---fn-,n-p---fv-,n-p---fn-,n-p---fv-
τύνη	p-s---mv-	p2s----n-
ἐάων	a-p---ng-	a-p----g-
φέρτατός	a-s---mns	a-s---mn-
αὐτῇς	a-p---fd-	p-p---fd-
παραιφάμενοι	v-pppemn-	v-pppmmn-,v-pppmmv-,a-p---mn-,a-p---mv-
νεοκηδέι	a-s---md-	a-s----d-
[οἵ	l--------	p-s---md-,p-s---fd-,l-p---mn-,l-p---mv-,p-p---mn-
ἑαυτῇ	a-s---fd-	p-s---fd-
καρχαρόδοντα	a-s---fa-	n-p---nn-,n-p---nv-,n-p---na-,n-s---ma-,n-s---fa-,n-s---ma-,n-s---fa-
ᾗς	p-p---fd-	v2sasa---,v2sasa---
Κλωθώ	n-s---fa-	n-s---fn-
Πλωτώ	n-s---fn-	a-d---mn-,a-d---nn-,a-d---mv-,a-d---nv-,a-d---ma-,a-d---na-
ῥοδόπηχυς	a-s---fn-	a-s---mn-
Ἀελλώ	n-s---fa-	n-s---fn-,n-d---mn-,n-d---mv-,n-d---ma-
Ἐνυώ	n-s---fa-	n-s---fn-
ἀγήρῳ	a-p---fn-	a-s---md-,a-s---fd-,a-s---nd-
εἰλιπόδεσσι	n-p---md-	a-p---md-,a-p---fd-,a-p---nd-
Ἀρίμοισιν	n-p---md-	a-p---md-,a-p---nd-
ὄφιος	n-s---fg-	n-s---mg-
ἐλεφαίρετο	v3sii----	v3siie---
Ἀπέσαντος	n-s---mg-	v-sapamg-,v-sapang-,v-sapamg-,v-sapang-
ὁπλότατον	a-s---mas	a-s---ma-,a-s---nn-,a-s---nv-,a-s---na-
Σιμοῦντα	a-s---ma-	n-s---ma-,v-pppann-,v-pppanv-,v-pppana-,v-sppama-
Πρυμνώ	n-s---fn-	n-d---nn-,n-d---nv-,n-d---na-,a-d---mn-,a-d---nn-,a-d---mv-,a-d---nv-,a-d---ma-,a-d---na-
Ἰδυῖά	n-s---fn-	v-srpafn-,v-srpafv-,v-srpafn-,v-srpafv-
Τελεστώ	n-s---fn-	a-d---mn-,a-d---nn-,a-d---mv-,a-d---nv-,a-d---ma-,a-d---na-
πρεσβύταται	a-p---fns	a-p---fn-,a-p---fv-
ἀγανώτατον	a-s---fas	a-s---mas,a-s---nns,a-s---nvs,a-s---nas,a-s---mas,a-s---nns,a-s---nvs,a-s---nas
Δήμητρα	n-s---fa-	n-s---fn-,n-s---fv-
ἁπάντη	d--------	v3siia---,v2spma---,v3siia---,v2spma---,v3siia---,v2spma---,v3siia---,v2spma---,a-p---nn-,a-p---nv-,a-p---na-,a-d---mn-,a-d---fn-,a-d---nn-,a-d---mv-,a-d---fv-,a-d---nv-,a-d---ma-,a-d---fa-,a-d---na-,a-s---ma-,a-s---fa-
ὑπερμενέι	a-s---md-	a-s----d-
ζεῦ	n-s---mv-	v2spme---,v2siie---
Μελίῃσι	a-p---md-	n-p---fd-,n-p---fd-
κεφαλῆφιν	n-s---fd-	n-----fg-
δαίδαλα	n-p---na-	a-p---nn-,a-p---nv-,a-p---na-,v1saia---
[τῆς	p-s---fg-	l-s---fg-
παρέσχεθεν	v3siia---	v3saia---
δαῒ	n-s---md-	g--------,n-s---fv-,n-s---fv-
ἐλιλαίετο	v3siie---	v3siim---
πίλνατο	v3siie---	v3siim---
ἐπιδέρκεται	v3spie---	v3spim---
ἀπέσσυτο	v3saim---	v3siim---
οὔρεος	n-s---ng-	n-s----g-
συνάντωνται	v3ppse---	v3ppsm---
δερκομενάων	v-pppefg-	v-pppmmg-,v-pppmfg-
τέξῃ	v3sfim---	n-s---fd-,v2sfim---
ἀγήρω	a-s---fa-	a-d---mn-,a-d---fn-,a-d---nn-,a-d---mv-,a-d---fv-,a-d---nv-,a-d---ma-,a-d---fa-,a-d---na-,a-s---mg-,a-s---fg-,a-s---ng-,n-s---ma-,n-s---fa-
Ἰδυῖαν	n-s---fa-	v-srpafa-,v-srpafa-
εἰλιπόδων	n-p---mg-	a-p---mg-,a-p---fg-,a-p---ng-
[Τηλέγονον	n-s---ma-	a-s---ma-,a-s---fa-,a-s---nn-,a-s---nv-,a-s---na-
Χαλκιδεὺς	a-s---mn-	n-s---mn-
τισιν	p-p---md-	p-p----d-
Μυρτώ	n-s---fa-	n-s---fn-
ἐννεακαίδεκα	a--------	m--------
ἀποκτείνει	v3saia---	v3sasa---,v2spie---,v3spia---
λοιδορεῖται	v3spip---	v3spie---
ἐσχηκέναι	v--pna---	v--rna---,v--rna---
Ὅπλητος	n-s---mg-	n-s----g-
Ἀναξώ	n-s---fa-	n-s---fn-
Μολοττοὺς	n-p---ma-	a-p---ma-,a-p---fa-
σκίμπους	n-s---mn-	a-s---mn-,a-s---fn-,a-s---mv-,a-s---fv-
Ἄμφις	n-s---mn-	n-s---fn-
αἰσθάνονται	v3ppie---	v3ppim---
Θεανώ	n-s---fa-	n-s---fn-
Κιρραῖοι	n-p---mn-	a-p---mn-,a-p---mv-
Κιρραίων	n-p---mg-	a-p---fg-,a-p---mg-,a-p---ng-
Κυρηναίους	n-p---ma-	a-p---ma-
Ἀμάσιδος	n-s---mg-	n-s---fg-
Ῥόδιοί	n-p---mn-	a-p---mn-,a-p---mv-,a-p---mn-,a-p---mv-
τιμᾶται	v3spip---	v3spse---,v3spie---
Ἀραρὼς	n-s---mn-	n-p---ma-,v-srpamn-,v-srpamv-
Ἀττικόν	n-s---ma-	a-s---ma-,a-s---nn-,a-s---nv-,a-s---na-
ἄρρενος	n-s---mg-	n-s----g-
παρωνύμιον	n-s---na-	a-s---ma-,a-s---fa-,a-s---nn-,a-s---nv-,a-s---na-,v3piia---,v1siia---
γεννᾶν	v-spna---	n-p---fg-,n-p---fg-,n-p---mg-,v-sppamv-,v-sppann-,v-sppanv-,v-sppana-,v-sppamn-,v--pna---,v--pna---
προκρίνομεν	v1paia---	v1pasa---,v1ppia---,v1piia---
γυμνοῦν	v-spna---	v-sppamv-,v-sppann-,v-sppanv-,v-sppana-,v--pna---
ἥδιστόν	a-s---nas	a-s---ma-,a-s---nn-,a-s---nv-,a-s---na-
Ἀμμωνίου	n-s---mg-	a-s---mg-,a-s---ng-
Ἀμάσιος	n-s---mg-	n-s---fg-
ὦναιδές	n-s---mv-	v2siia---
Φάνιον	n-s---fn-	v3piia---,v1siia---
Λοπάδιον	n-s---fn-	n-s---nn-,n-s---nv-,n-s---na-
πριάμενὸν	v-sppema-	v-sppmma-,v-sppmnn-,v-sppmnv-,v-sppmna-
χὢν	p-p---mg-	p-s---ma-,p-s---na-
νεοττὸς	n-s---fn-	n-s---mn-
Μαραθωνίοις	n-p---md-	a-p---md-,a-p---nd-
Ἀβυδηνοῖς	n-p---md-	a-p---md-,a-p---nd-
τοξοφόροισιν	a-p---md-	n-p---md-,n-p---fd-
πτάμεναι	v-papmfv-	v--ana---,v-pfpmfn-,v-pfpmfv-
Ἀφροδίσια	n-p---na-	a-p---nn-,a-p---nv-,a-p---na-,a-p---nn-,a-p---nv-,a-p---na-,a-p---nn-,a-p---nv-,a-p---na-,a-p---nn-,a-p---nv-,a-p---na-
Ἀττικάς	n-p---fa-	a-p---fa-
Ἀδριανοῦ	n-s---mg-	a-s---mg-,a-s---ng-
Μαραθῶν	n-p---mg-	n-p---fg-
Ὁμάρτης	n-s---mn-	v2siia---
Ἀβροτόνου	n-s---fg-	n-s---ng-
Ἀβρότονον	n-s---fn-	n-s---nn-,n-s---nv-,n-s---na-
Εὐεργέτης	a-s---mn-	n-s---mn-,n-s---mn-,v2siia---,v2siia---
Μύρτιον	n-s---fa-	n-s---nn-,n-s---nv-,n-s---na-
Ποθεινῆς	n-s---fg-	a-s---fg-
Ποθεινὴ	n-s---fn-	a-s---fn-,a-s---fv-
Θρᾴττης	a-s---fg-	n-s---fg-,n-s---fg-
Καινῆς	n-s---fg-	n-p---mn-,n-p---mn-,n-p---mv-,v2spia---,a-s---fg-
Βόας	n-s---fn-	n-p---fa-,n-s---fg-,v2siia---,n-p---ma-,n-p---fa-
Ποικίλης	n-s---fg-	n-s---mn-,a-s---fg-
Σικυωνίοις	n-p---md-	a-p---md-,a-p---nd-,a-p---nd-,a-p---md-,a-p---nd-
εἴσει	v2sfia---	v3sasa---,v2spia---,v2sfim---,v2sfim---
Δημώ	n-s---fa-	n-s---fn-,n-d---mn-,n-d---mv-,n-d---ma-
Μύσταν	n-s---fa-	n-s---ma-,n-s---ma-
Δημὼ	n-s---fa-	n-s---fn-,n-d---mn-,n-d---mv-,n-d---ma-
καὐτόν	a-s---fa-	p-s---ma-
ἐπιγελᾶν	v-spna---	v-sppamv-,v-sppann-,v-sppanv-,v-sppana-,v-sppamn-,v--pna---,v--pna---,v-sppamv-,v-sppann-,v-sppanv-,v-sppana-,v-sppamn-,v--pna---,v--pna---,v-sfpamv-,v-sfpann-,v-sfpanv-,v-sfpana-,v-sfpamn-,v--fna---
ἱστῶντα	v-pppama-	v-pppann-,v-pppanv-,v-pppana-,v-sppama-
διψᾶν	n-s---fa-	n-p---fg-,v-sppamv-,v-sppann-,v-sppanv-,v-sppana-,v-sppamn-,v--pna---
Ὑὸς	n-s---fn-	n-s---mg-,n-s---fg-,n-s---mn-
Ἄστρα	n-s---fn-	n-p---nn-,n-p---nv-,n-p---na-,n-p---nn-,n-p---nv-,n-p---na-
Λύχνος	n-s---fn-	n-s---mn-
αἰτίον	a-s---na-	v-sppamv-,v-sppann-,v-sppanv-,v-sppana-
προσενέγκασα	v-papana-	v-sapafn-,v-sapafv-
Λεόντιον	n-s---fn-	n-s---nn-,n-s---nv-,n-s---na-,n-s---ma-,n-s---nn-,n-s---nv-,n-s---na-
Αἰγεῖ	n-s---mn-	n-s---md-,n-d---fn-,n-d---fv-,n-d---fa-,n-s---fd-
Ἀφροδίσιον	n-s---fn-	a-s---ma-,a-s---nn-,a-s---nv-,a-s---na-,a-s---ma-,a-s---fa-,a-s---nn-,a-s---nv-,a-s---na-,a-s---ma-,a-s---nn-,a-s---nv-,a-s---na-,a-s---ma-,a-s---fa-,a-s---nn-,a-s---nv-,a-s---na-
Ἀρισταγόρας	n-s---fg-	n-p---ma-,n-s---mn-
νεοσπάδα	a-s---ma-	n-s---ma-,n-s---fa-
μέθυσον	a-s---fa-	a-s---ma-,a-s---nn-,a-s---nv-,a-s---na-,v2sama---
Ὠκίμου	n-s---fg-	n-s---ng-
Ναννάριον	n-s---fa-	n-s---nn-,n-s---nv-,n-s---na-
Σισύμβριον	n-s---fa-	n-s---nn-,n-s---nv-,n-s---na-,n-s---nn-,n-s---nv-,n-s---na-
Βάραθρον	n-s---fa-	n-s---nn-,n-s---nv-,n-s---na-,n-s---ma-
Θάλλουσαν	n-s---fa-	v-sppafa-
προιέμενος	v-sppemn-	v-sppmmn-
θαυμάσας	v-sppamn-	v-pfpafa-,v-sfpafg-,v-sapamn-,v-sapamv-
ἡδὶ	a-s---fn-	p-s---fn-
μονοχίτων	a-s---fn-	n-s---mn-,n-s---fn-,n-s---mv-,n-s---fv-
Ἀρισταγόραν	n-s---fa-	n-s---ma-
Πεντελικοῦ	a-s---mg-	n-s---mg-
Σαπέρδιον	n-s---fa-	n-s---nn-,n-s---nv-,n-s---na-
ἀναίνεσθαι	v--pne---	v--pnm---
στασίμῳ	n-s---nd-	a-s---md-,a-s---fd-,a-s---nd-
Λεοντίου	n-s---fg-	n-s---ng-,n-s---mg-,n-s---ng-
Μύστα	n-s---fn-	n-d---mn-,n-d---mv-,n-d---ma-,n-s---mv-,n-s---mg-,n-s---mn-
Στρατόλας	n-s---fg-	n-p---ma-,n-s---mn-
Φρυνίων	n-s---mn-	n-p---ng-
Φανὼ	n-s---fa-	n-d---mn-,n-d---mv-,n-d---ma-,a-d---mn-,a-d---nn-,a-d---mv-,a-d---nv-,a-d---ma-,a-d---na-,n-d---mn-,n-d---mv-,n-d---ma-
Κιλικίᾳ	n-s---fd-	a-s---fd-,a-s---fd-
χέδροπα	n-s---ma-	n-p---nn-,n-p---nv-,n-p---na-
Αἰσωπείᾳ	n-s---fd-	a-s---fd-
Παρόραμα	n-s---fa-	n-s---nn-,n-s---nv-,n-s---na-
Λυδήν	n-s---fa-	a-s---fa-
Λυδὴν	n-s---fa-	a-s---fa-
Λυδῆς	n-s---fg-	a-s---fg-
Δήμητρᾳ	n-s---fa-	n-p---fn-,n-p---fv-
Ἠοίην	n-s---fa-	a-s---fa-,a-s---fa-
Κολοφῶνα	n-s---fa-	n-s---ma-,n-s---ma-
δείρῃ	n-s---fd-	v2sasm---,v3sasa---,v2spse---,v2spie---,v3spsa---
πολυπρήωνα	n-s---fa-	n-s---ma-
μάκαιρα	a-s---fn-	n-s---fn-,n-s---fv-
πραγματεία	a-p---na-	n-d---fn-,n-d---fv-,n-d---fa-,n-s---fn-,n-s---fv-
Φαλάριδι	n-s---md-	n-s---fd-
Φάλαριν	n-s---ma-	n-s---fa-
ἐπιθῶνται	v3pasm---	v3ppse---,v3ppsm---
ἀκεῖ	d--------	v2sfim---,v2spie---,v2spie---,v3spia---
Φαρσαλίᾳ	n-s---fd-	a-s---fd-
Φαρσαλία	n-s---fn-	a-d---fn-,a-d---fv-,a-d---fa-,a-s---fn-,a-s---fv-
περιστερά	n-s---mn-	n-d---fn-,n-d---fv-,n-d---fa-,n-s---fn-,n-s---fv-
χὴν	n-s---mn-	n-s---fn-,n-s---fv-
νεῷ	n-s---md-	v3spoa---,v3sfoa---
Λευκαδίᾳ	n-s---fd-	a-s---fd-
Ἰασοῦ	n-s---fg-	n-d---fn-,n-d---fv-,n-d---fa-
πριαμένου	v-sppemg-	v-sppmmg-,v-sppmng-
τεσσαρεσκαίδεκα	a-p---m--	m-p---m--,m-p---f--
ὁμοπάτριος	a-s---fn-	a-s---mn-
Τιμῶσάν	n-s---fn-	v-sppafa-,v-sapann-,v-sapanv-,v-sapana-
Τενεδίοις	n-p---md-	a-p---md-,a-p---nd-
Ἵππων	n-s---mn-	n-p---mg-,n-p---mg-,n-p---fg-
Καρύστιός	n-s---mn-	a-s---mn-
ῥητορικὴν	n-s---fa-	a-s---fa-
πόρτιν	n-s---ma-	n-s---fa-
Τηρεΐας	a-s---fg-	n-p---fa-,n-s---fg-
ἀνθεμίζομαι	---------	v1spie---
τιμῶ	v2spme---	v1spsa---,v1spia---,v2siie---,v1spsa---,v1spia---,v1spsa---,v1spia---
καρβᾶνα	a-s---fa-	a-p---nn-,a-p---nv-,a-p---na-
δελτουμένας	v--ppefa-	v-pppefa-,v-sppefg-,v-pppefa-,v-sppefg-
ἀρχηγέται	n-p---mn-	n-p---fn-,n-p---fv-,n-s---fd-
μετωποσωφρόνων	a-p---ng-	a-p----g-,a-p----g-
πρόλεσχος	a-s---fn-	n-s---mn-
ἀνελληνόστολον	---------	a-s---ma-,a-s---fa-,a-s---nn-,a-s---nv-,a-s---na-
Περραίβων	---------	v3piia---,v1siia---
ἱπποβάμοσιν	a-p---md-	a-p----d-
ἀστυγειτονουμένας	---------	v-pppefa-,v-sppefg-,v-pppefa-,v-sppefg-
Ἰὼ	n-s---fn-	n-d---nn-,n-d---nv-,n-d---na-,n-d---mn-,n-d---mv-,n-d---ma-,n-d---nn-,n-d---nv-,n-d---na-,n-d---mn-,n-d---mv-,n-d---ma-,i--------
εὐκραίρῳ	a-s---fd-	a-s---md-,a-s---nd-
μεταπτοιοῦσαν	---------	v-sppafa-
ἱεροδόκα	---------	a-p---nn-,a-p---nv-,a-p---na-
κάθησθε	v2ppia---	v2prim---,v2pasm---
προσήμενοι	---------	v-prpmmn-,v-prpmmv-
δύσφρονος	a-s---mg-	a-s----g-
ἐκτελευτήσει	v3sfia---	v3sasa---,v3sasa---
διορνυμένα	---------	v-dppefn-,v-dppefv-,v-dppefa-,v-sppefn-,v-sppefv-
Τυφῶ	n-s---mg-	n-s---md-,v1sasp---,v1sasp---,v1spsa---,v1spia---,n-s---md-
Ἰώ	n-s---fa-	n-d---nn-,n-d---nv-,n-d---na-,n-d---mn-,n-d---mv-,n-d---ma-,n-d---nn-,n-d---nv-,n-d---na-,n-d---mn-,n-d---mv-,n-d---ma-,i--------
ἡμένου	v-srpemg-	v-srpmmg-,v-srpmng-
δημηγόρους	a-p---fa-	n-p---ma-,n-p---ma-
προσαπαντᾶν	---------	v-sppamv-,v-sppann-,v-sppanv-,v-sppana-,v-sppamn-,v--pna---,v--pna---
κῶν	n-p---fg-	v-sppamn-
προμαθὶς	a-s---fn-	n-s---fn-
εὐκοινόμητις	a-s---fn-	n-s----n-
δολιομήτιδες	a-p---mn-	n-p---fn-,n-p---fv-,n-p---fn-,n-p---fv-
δαΐκτορος	---------	n-s---mg-,n-s---mg-
ἐλευθεροῦ	---------	v2spme---,v2siie---
κάκκας	---------	n-p---fa-,n-s---fg-,v2siia---
ἀμφαίνω	---------	v1spsa---,v1spia---
γαϊάναξ	---------	n-s---mn-,n-s---mv-
σοῦσθε	v2ppme---	v2ppmm---
δεσποσίῳ	a-s---fd-	a-s---md-,a-s---nd-
αἵμονες	a-p---fn-	n-p---mn-,n-p---mv-
βάτεαι	---------	v2spie---
ὑπερθορῇ	v2sfie---	v2sfim---
ἀτᾷ	v3spia---	v2spsp---,v2spip---
πᾶ	n-s---mv-	n--------
κατεσφραγισμένα	v--rpenn-	v-prpenn-,v-prpenv-,v-prpena-,v-drpefn-,v-drpefv-,v-drpefa-,v-srpefn-,v-srpefv-
ἄρσεσιν	n-p---md-	n-p----d-,n-p---fd-,n-p---nd-
μύσαγμά	n-s---na-	n-s----n-,n-s----v-,n-s----a-
γανάοντες	v-pppamn-	a-p---mn-,a-p---mv-
περιναίουσιν	v3ppi----	v-pppamd-,v-pppand-,v3ppia---,v-pppamd-,v-pppand-,v3ppia---
στυγίων	---------	n-p---ng-,v-sppamn-
θέλκτορι	n-s---fd-	n-s---md-
ἕπε	---------	v3siia---
δήπουθεν	d--------	g--------
Κλειτορίων	n-p---mg-	a-p---fg-,a-p---mg-,a-p---ng-
ἀπεχθανομένων	v-pppemg-	v-pppmfg-,v-pppmmg-,v-pppmng-
γεννηθέν	v3saip---	v-sappnn-,v-sappnv-,v-sappna-
Θάλητα	n-s---mv-	n-p---nn-,n-p---nv-,n-p---na-,n-s---ma-,n-s---fa-
ἀκροώμενοι	v-pppemn-	v-pppmmn-,v-pppmmv-,v-pfpemn-,v-pfpemv-
Ἰνδικὴν	n-s---fa-	a-s---fa-
Ἀθανᾶς	n-s---fg-	a-p---ma-,a-p---fa-
Χείμαρρος	n-s----a-	n-s---mn-,a-s---mn-,a-s---fn-,a-s---mn-,a-s---fn-
Οἰνοῦντα	n-s---ma-	v-pppann-,v-pppanv-,v-pppana-,v-sppama-
κυροῦν	v--pia---	v-sppamv-,v-sppann-,v-sppanv-,v-sppana-,v-sppamv-,v-sppann-,v-sppanv-,v-sppana-,v--pna---
ἀκτημόνων	a-p---ng-	a-p----g-
ἡμίσεις	a-p---ma-	a-p---mn-
πρίασθαί	v--pne---	v--pnm---
φειδὼ	n-s---na-	a-d---mn-,a-d---nn-,a-d---mv-,a-d---nv-,a-d---ma-,a-d---na-,n-s---fn-
ἡδομένους	v-papmma-	v-pppema-
Θηβαίους	n-p---ma-	a-p---ma-
Ἀνταλκίδας	n-s---ma-	n-p---ma-,n-s---mn-
ἔλυε	v3spia---	v2spma---,v3siia---,v3siia---,v3siia---
πρεσβυτάτους	a-p---mas	a-p---ma-
ἀντίχειρα	n-s---md-	n-s---ma-,n-p---nn-,n-p---nv-,n-p---na-
μηχανώμενος	v-spiemn-	v-sppemn-
τὶν	p-s---ma-	p2s----a-,p2s----d-
ποιοῦντι	v3spia---	v-sppamd-,v-sppand-,v3ppia---,v-sppamd-,v-sppand-,v3ppia---
αὐτᾶς	a-s---fg-	p-s---fg-
Φιλοστέφανος	n-s---mn-	a-s---mn-,a-s---fn-
Πελοποννησιακοῖς	n-p---md-	a-p---md-,a-p---nd-
Σπένδοντος	n-s---mg-	v-sppamg-,v-sppang-
ἡγουμένην	v-sppefa-	v-sppmfa-
εὔρινος	a-s---fg-	a-s---mn-,a-s---fn-,a-s---mn-,a-s---fn-,n-s---mg-,n-s---fg-
στρατηγίσιν	a-p---fd-	n-p---fd-
πολύκερων	a-s---ma-	n-s---ma-,n-s---fa-
μανιάσιν	a-p---fd-	n-p---fd-
οὕτος	p-s---mv-	n-s---nn-,n-s---nv-,n-s---na-
προνούστερος	a-s---mnc	a-s---mn-
ἀμφιρύτου	a-s---fg-	a-s---mg-,a-s---ng-
χἠμεῖς	p-p---mn-	p1p---mn-,p1p---fn-,p1p---mv-,p1p---fv-
μακραίωνι	a-s---fd-	n-s---md-,n-s---fd-
ἄϊδρις	a-s---fn-	n-s---mn-,n-s---fn-
αἴθονος	a-s---mg-	a-s----g-
ἱππονώμας	a-p---ma-	n-p---ma-,n-s---mn-
δεσμῶτιν	a-s---fa-	n-s---fa-
ἱπποδέτην	a-s---ma-	n-s---ma-
σιδηροκμῆσιν	a-p---nd-	n-p---md-,n-p---fd-
ὕπεικε	v2spma---	v3siia---
ἑλίκεσσι	a-p---md-	n-p---md-,n-p---fd-,n-p---fd-
προπάτωρ	n-s---mv-	n-s---mn-
δισσάρχας	a-p---ma-	n-p---ma-,n-s---mn-
καὐτός	a-s---mn-	p-s---mn-
ἐλάσσονι	a-s---ndc	a-s----dc
γοργῶπις	a-s---fn-	n-s---fn-,n-s---fn-
ἐνάλιος	a-s---mv-	a-s---mn-
ὑπείκει	v3spia---	v3slia---
Τρῳάδι	a-s---fd-	n-s---fd-
σιδηροβρῶτι	a-s---fd-	n-s---md-,n-s---fd-,n-s---fv-
τοσαῦτά	a-p---na-	p-p---nn-,p-p---nv-,p-p---na-
τανύποδας	n-p---fa-	a-p---ma-,a-p---fa-
διφρηλατῶν	v-sppamv-	n-p---mg-,v-sppamn-
ταλαίφρων	a-s---fv-	n-s---mn-,n-s---fn-,n-s---mv-,n-s---fv-
στερεόφρων	a-s---mn-	n-s---mn-,n-s---fn-,n-s---mv-,n-s---fv-
ἀριστόχειρ	a-s---mn-	n-s---mn-,n-s---fn-
κελαινώπαν	a-s---ma-	n-s---ma-
μηχανᾶν	v--pna---	n-p---fg-
ἡγεῖσθαί	v--pne---	v--pnm---
μηδένας	n-p---ma-	p-p---ma-,p-p---fa-
ὑπέρφρονα	a-p---na-	n-s---ma-,n-s---fa-
χἠμᾶς	p-p---ma-	p1p---ma-,p1p---fa-,a-s---fg-
αἰσχίστους	a-p---mas	a-p---ma-
βάτω	v3spma---	n-s---mg-,n-d---nn-,n-d---nv-,n-d---na-,n-s---ng-,n-d---fn-,n-d---fv-,n-d---fa-,n-s---fg-,n-d---mn-,n-d---mv-,n-d---ma-,n-s---mg-
κοὐδενί	a-s----d-	p-s----d-
στάθητε	v2pamp---	v2paip---
ἀργηστὴς	a-s---mn-	n-s---mn-,n-s---mn-
δορυσσοῖς	a-p---fd-	a-p---md-,a-p---nd-
χαῖα	a-p---na-	n-p---nn-,n-p---nv-,n-p---na-
ποτίφατον	a-s---ma-	v2dpma---,v2dpia---,v3dpia---,v2diia---
δᾶν	n-s---mn-	i--------
πευθώ	n-s---fa-	n-s---fn-
ὑπέρφρον	a-s---na-	n-s---mv-,n-s---fv-
πανσέληνος	n-s---fn-	a-s---mn-,a-s---fn-
φόρους	a-p---ma-	n-p---ma-
Νηίστῃσι	n-s---fd-	a-p---fd-
χοὖτος	a-s---mn-	p-s---mn-,p-s---mv-
ἅλω	n-s---fa-	n-s---fg-,n-s----g-,v3saia---,v3saia---,n-d---mn-,n-d---mv-,n-d---ma-,n-s---mg-
ὄφεων	n-p---fg-	n-p---mg-
ταρφὺς	a-s---fn-	a-s---mn-,a-s---mn-
εἰκὼ	n-s---fa-	n-s---fn-
ἀμνήμοσιν	a-p---md-	a-p----d-
ἡγουμένη	v-sppefn-	v-sppmfn-,v-sppmfv-
ξυλλογῇ	n-s---fd-	v2spse---,v2spie---,v3spsa---,v3spia---,v2spse---,v2spie---,v3spsa---
βλαψίφρονος	a-s---mg-	a-s----g-
παιδολέτωρ	n-s---fn-	n-s---mn-,n-s---mn-
γαΐα	---------	n-d---fn-,n-d---fv-,n-d---fa-,n-s---fn-,n-s---fv-,n-d---fn-,n-d---fv-,n-d---fa-
καμψίπους	n-s---fn-	a-s---mn-,a-s---fn-,a-s---mv-,a-s---fv-
διδυμάνορα	---------	n-s---ma-,n-s---fa-
ἑλόν	---------	v-sapamv-,v-sapann-,v-sapanv-,v-sapana-
διχόφρονι	a-s---md-	a-s----d-
ἁμῶν	p-p---mg-	a-p---fg-,a-p---mg-,a-p---ng-,p1p---mg-,p1p---fg-
αὑτᾷ	a-s---fd-	p-s---fd-
τροπαῖον	n-s---nn-	a-s---ma-,a-s---nn-,a-s---nv-,a-s---na-
ἀδελφεῶν	a-p---ng-	n-p---fg-,n-p---mg-
ὁμαίμονα	a-p---nn-	n-s---ma-
καὐτὴ	a-s---fn-	p-s---fn-,p-s---fv-
αἰνυμένην	v-sppefa-	v-sppmfa-
καλυκώπιδι	a-s---fd-	n-s---fd-
ὄρθια	d--------	a-p---nn-,a-p---nv-,a-p---na-,a-p---nn-,a-p---nv-,a-p---na-
Πολυσημάντωρ	a-s---mn-	n-s---mn-
ἤλπετο	v3siie---	v3siim---
φαινολὶς	a-s---fn-	n-s---fn-
καταδέρκεαι	v2spie---	v2spim---
πίλνασαι	v2spie---	v2spim---
ἀφήλικος	a-s---fg-	a-s---mn-,a-s---fn-,n-s---mg-,n-s---fg-
ἠύτε	c--------	g--------
νήιδες	a-p---mv-	n-p---mn-,n-p---fn-,n-p---mv-,n-p---fv-
προγνώμεναι	v-papmfn-	v--ana---
ἔσσυτο	v3siie---	v3siim---
εὐώπιδα	a-s---fa-	n-p---nn-,n-p---nv-,n-p---na-,n-s---ma-,n-s---fa-
χρυσόρραπιν	a-s---ma-	n-s---ma-,n-s---fa-
παραιφάμενος	v-sppemn-	v-sppmmn-,a-s---mn-
κυανοχαῖτα	a-s---mv-	n-s---mv-,n-s---mn-
μ[ὴ	d--------	c--------
Ἰάχη	n-s---fn-	v3slia---,v1slia---,v1slia---,v3siia---,v2spma---
ἐγρεμάχη	a-s---fn-	n-s---mv-
πίονες	a-p---mn-	n-p---mn-,n-p---fn-,n-p---mv-,n-p---fv-
βριάοντα	v-sppama-	v-pppan--
ἀρώμεναι	v--pna---	v-pppefn-,v-pppefv-,v-pfpmfn-,v-pfpmfv-,v-pppefn-,v-pppefv-
δίκασσαι	v--ana---	v2samm---
ἐξαλέασθαι	v--anp---	v--anm---
ἄ]λλο	a-s---na-	p-s---nn-,p-s---nv-,p-s---na-
κακίστη	a-s---fns	a-s---fn-,a-s---fv-
ἀροτῆρα	a-s---ma-	n-s---ma-
ἔνηφιν	a-p---fd-	d--------
τριπόδην	a-s---ma-	n-s---ma-
ἑπταπόδην	a-s---ma-	n-s---ma-
ἄρσενε	a-d---ma-	n-d----n-,n-d----v-,n-d----a-
ἀβούτεω	a-s---mg-	n-s---mg-
ἁδροσύνη	n-s---fd-	n-s---fn-,n-s---fv-
αἰρεύμενον	v-sppema-	v-sppmma-
πρῳηρότῃ	n-s---md-	n-s---fd-
πενίη	n-s---fd-	n-s---fn-,n-s---fv-
ἁπαλόχροος	a-s---fg-	a-s---mn-,a-s---fn-
πετρῆεν	a-s---na-	a-s---mv-,a-s---nn-,a-s---nv-
ἀλευόμενοι	v-pppemn-	v-pppmmn-,v-pppmmv-
ὀρθογόη	a-s---fn-	n-s---fn-,n-s---fv-
μάζα	n-s---fn-	n-d---fn-,n-d---fv-,n-d---fa-
εὐαέι	a-s---md-	a-s----d-
ἔριθον	n-s---fa-	n-s---ma-
ὑπόπορτις	a-s---fn-	n-s---fn-
ἔριθος	n-s---fn-	n-s---mn-
ἀφύσσαι	v--ana---	n-s---fd-,v3saoa---
ἐντύνασθαι	v--pne---	v--anm---,v--anm---
Αἰολίδα	a-s---fa-	n-s---fa-,n-d---mn-,n-d---mv-,n-d---ma-,n-s---mv-,n-s---mg-,n-s---mn-,n-s---fa-
κύρσαι	v--ana---	v3saoa---
τριηκόντων	m--------	m-p----g-
τίνυσθαι	v--pne---	v--pnm---
ἐμπελαδὸν	r--------	d--------
κρώξῃ	v3sasa---	v2sfim---
χυτροπόδων	n-p---mg-	a-p---mg-,a-p---fg-,a-p---ng-
ἔνη	a-s---fn-	v3siia---,v3siia---,v3siia---,v3siia---,v3siia---
χρυσάορα	a-s---ma-	a-p---nn-,a-p---nv-,a-p---na-,n-s---ma-,n-s---fa-
ἵστορα	a-s---ma-	n-s---ma-,n-s---fa-
πολυκλήιδα	a-s---fa-	n-s---fa-
τουτουὶ	a-s---ng-	p-s---mg-
τουτῳὶ	a-s---md-	p-s---md-
μηδενὶ	a-s---fd-	p-s----d-
πρεσβύτατόν	a-s---mas	a-s---ma-,a-s---nn-,a-s---nv-,a-s---na-
τουτονὶ	a-s---ma-	p-s---ma-
ταυτησὶ	a-s---fg-	p-s---fg-
οὑτοσί	a-s---mn-	p-s---mn-,p-s---mv-
Διρκαίων	a-p---ng-	n-p---ng-
ὀξυτέρῳ	a-s---mdc	a-s---md-,a-s---nd-
αὑτοῖν	a-d---md-	p-d---nd-,p-d---md-,p-d---ng-,p-d---mg-
αὐτόχειρι	a-s---nd-	n-s---md-,n-s---fd-
ἀδελφὰ	a-p---na-	n-d---fn-,n-d---fv-,n-d---fa-,n-s---fn-,n-s---fv-
ὑπερτάταν	a-s---fas	a-s---fa-,a-s---fa-
ἀνεμόεν	a-s---na-	a-s---mv-,a-s---nn-,a-s---nv-
ὑπαίθρεια	a-p---na-	n-s---fn-,n-s---fv-
μηχανόεν	a-s---na-	a-s---mv-,a-s---nn-,a-s---nv-
ὑψίπολις	a-s---mn-	n-s---fn-
ἀντιλογήσω	v1sa-a---	v2saim---,v1sasa---,v1sfia---,v1stia---,v2saim---
χαὔτη	a-s---fn-	p-s---fn-,p-s---fv-
χοὖτοι	a-p---mn-	p-p---mn-,p-p---mv-
αἱματόεν	a-s---na-	a-s---mv-,a-s---nn-,a-s---nv-
ἁμὲ	p-p---ma-	a-s---mv-,p1p---ma-,p1p---fa-
Σιπύλῳ	n-s---md-	n-s---fd-
αὑταὶ	a-p---fn-	p-p---fn-,p-p---fv-
εὔιόν	a-s---na-	n-s---ma-
ὀρθόποδος	n-s---mg-	a-s---mg-,a-s---fg-,a-s---ng-
ἐκείνᾳ	a-s---fd-	p-s---fd-
θυστάδας	a-p---fa-	n-p---fa-
ἐπιστάμεσθα	v1ppie---	v1piie---,v1piie---,v1paim---,v1piie---,v1pfim---
Δῃοῦς	n-s---fg-	v2spia---,v2spia---
Νυσαίων	a-p---ng-	n-p---mg-,n-p---mg-
κἀκείνων	a-p---mg-	p-p---ng-,p-p---fg-,p-p---mg-,v3piia---,v1siia---
Ῥωμαῖοί	n-p---mn-	a-p---mn-,a-p---mv-
ὡσανεὶ	d--------	g--------
προδήλους	a-s---fa-	a-p---ma-,a-p---fa-,v2siia---,v2siia---
Σύνεις	n-p---fa-	v2spia---
προσκαθῆσθαι	v--rne---	v--pnm---
κεκουφίσθαι	v--rnp---	v--rne---
Λιγυστίνους	n-p---ma-	a-p---ma-
ἀκροβολιζόμενοι	v-pppemn-	v-pppmmn-,v-pppmmv-
Λιπαραίων	n-p---mg-	a-p---fg-,a-p---mg-,a-p---ng-,a-p---fg-,a-p---mg-,a-p---ng-
Βοώδη	n-s---ma-	a-p---nn-,a-p---nv-,a-p---na-,a-d---mn-,a-d---fn-,a-d---nn-,a-d---mv-,a-d---fv-,a-d---nv-,a-d---ma-,a-d---fa-,a-d---na-,a-s---ma-,a-s---fa-
προσήρμοστο	v3slip---	v3slie---
συνδεδέσθαι	v--rnp---	v--rne---
Λιπαραίους	n-p---ma-	a-p---ma-,a-p---ma-
Λιπαραίας	n-p---fa-	a-p---fa-,a-s---fg-,a-p---fa-,a-s---fg-
ὠνομάζοντο	v3piip---	v3piie---
εἴκοσιν	a--------	m--------
ἡγουμένων	v-pppemg-	v-pppmfg-,v-pppmmg-,v-pppmng-
τετραπόδου	n-s---fg-	a-s---mg-,a-s---fg-,a-s---ng-,n-s---mg-
Καρχηδονίων]	n-p---mg-	a-p---fg-,a-p---mg-,a-p---ng-,a-p---fg-,a-p---mg-,a-p---ng-
εὔελπις	n-s---fn-	n-s----n-
βελτίονος	a-s---ngc	a-s----gc
Ὠρίωνος	n-s---fg-	n-s---mg-
στενῶν	n-p---fg-	n-p---ng-,v-sfpamv-,v-sfpann-,v-sfpanv-,v-sfpana-,v-sfpamn-,a-p---fg-,a-p---mg-,a-p---ng-,v-sppamv-,v-sppann-,v-sppanv-,v-sppana-,v-sppamn-,v--pna---
ἀκροβολιζομένοις	v-pppemd-	v-pppmmd-,v-pppmnd-
καταλείπεσθαι	v--pnp---	v--pne---
δεκαδύο	a--------	m--------
Ἀκραγαντίνοις	n-p---md-	a-p---md-,a-p---nd-
εἴσπλουν	n-s---md-	n-s---ma-,v3piia---,v1siia---
φορτηγοῖς	a-p---fd-	v2spoa---,a-p---md-,a-p---nd-,n-p---md-
φορτηγοὺς	a-p---fa-	a-p---ma-,n-p---ma-
Βάρκαν	n-s---ma-	n-s---fa-,n-s---fa-
περίμετρος	n-s---fn-	a-s---mn-,a-s---fn-
Κυμαίων	n-p---fg-	a-p---fg-,a-p---mg-,a-p---ng-
ἀναπείρας	n-p---ma-	n-p---fa-,n-s---fg-,v-sapamn-,v-sapamv-,v2siia---
θετέον	a-s---fn-	a-s---ma-,a-s---nn-,a-s---nv-,a-s---na-
Βάρκας	n-s---mn-	n-p---fa-,n-s---fg-,n-p---fa-,n-s---fg-
αἰσθάνεσθαι	v--pne---	v--pnm---
Τύνητι	n-s---md-	n-s----d-
καθὼς	c--------	d--------
Μάθω	n-s---mg-	v1sasa---
τοσαύταις	a-p---fd-	p-p---fd-
ἡτισοῦν	a-s---fn-	p-s---fn-
τηλικούτων	a-p---fg-	p-p---mg-
γονεῖς	n-s---ma-	v2spia---,n-p---ma-,n-p---mn-,n-p---mv-
Τύνης	n-s---mn-	n-s----n-
Βάρκα	n-s---mg-	n-d---fn-,n-d---fv-,n-d---fa-,n-s---fn-,n-s---fv-,n-d---fn-,n-d---fv-,n-d---fa-,n-s---fn-,n-s---fv-
προεστήσαντο	v3paia---	v3paim---
Μακάρα	n-s---mg-	n-s---ma-,a-d---fn-,a-d---fv-,a-d---fa-,a-s---fn-,a-s---fv-
καταξίωσιν	n-s---ma-	v3ppsa---,n-s---fa-
Βάρκᾳ	n-s---mg-	n-p---fn-,n-p---fv-,n-s---fd-,n-p---fn-,n-p---fv-,n-s---fd-
ἐγκαταλιπουσῶν	v-papamg-	v-papafg-
Σαρδονίους	n-p---ma-	a-p---ma-,a-p---ma-
καθημένων	v-prpemg-	v-prpmfg-,v-prpmmg-,v-prpmng-
ἑλκῶν	n-p---mg-	n-p---ng-,v-sppamn-,v-sppamv-,v-sppann-,v-sppanv-,v-sppana-,v-sppamn-,v--pna---
Μακάραν	a-s---ma-	a-s---fa-
τολμήσει	v3sfia---	n-d---fn-,n-d---fv-,n-d---fa-,n-s---fd-,n-s---fd-,v3sasa---
Ἄϊδι	---------	n-s---md-
ἐϋκνήμιδες	a-p---mv-	n-p---fn-,n-p---fv-,n-p---mn-,n-p---mv-
ἐρείομεν	v1ppsa---	v1ppia---,v1piia---,v1piia---
χέρηϊ	a-s---md-	n-s---md-,n-s---fd-,n-s---nd-
ἥμιν	p-p---md-	p1p---md-,p1p---fd-
Φθίῃ	---------	a-s---fd-,n-s---fd-,v2sasm---,v2spse---,v2spie---,v3spsa---,a-s---fd-
ἐριβώλακι	a-s---fd-	n-s---md-,n-s---fd-
πολυάϊκος	---------	n-s---mg-,n-s---fg-
ἐπέσσυται	v3spie---	v3spim---
ὅττί	p-s---na-	c--------
Πατρόκλεες	n-s---mv-	n-p---mv-
ἑλίκωπες	a-p---mn-	n-p---mn-,n-p---fn-,n-p---mv-,n-p---fv-
σεο	p-s----g-	p2s----g-
κυδιάνειραν	a-s---fa-	n-s---fa-
πολυδειράδος	a-s---mg-	n-s---mg-,n-s---fg-
κάθησο	v2srme---	v2srmm---
κλυτοτέχνης	a-s---mn-	n-s---mn-
αἴθωνος	a-s---mg-	n-s----g-
ὑπόσχηται	v3sasa---	v3sase---,v3sasm---
ἀλλήλοιιν	a-d---md-	p-d----g-,p-d----d-,p-d---ng-,p-d---nd-,p-d---mg-,p-d---md-
φθισήνορα	a-s---ma-	n-s---ma-,n-s---fa-
ἐέλπεται	v3spie---	v3spim---
ἐπενήνοθε	v3-iie---	v2srma---,v3sria---
ἔστρωτο	v3slip---	v3slie---
χαλκοχίτωνας	a-p---ma-	n-p---ma-,n-p---fa-
ἐριαύχενας	a-p---ma-	n-p---ma-,n-p---fa-
Θύμβρης	---------	n-s---mn-,n-s---fg-
ἱπποκορυσταί	a-p---mn-	n-p---mn-,n-p---mv-
πελάσσετον	---------	v3dasa---,v2dasa---,v3dfia---,v2dfia---
δίζυγες	a-p---mn-	n-p---mn-,n-p---fn-,n-p---mv-,n-p---fv-
θοῦριν	a-s---fa-	n-s---fa-
βλοσυρῶπις	a-s---fn-	n-s---fn-
Ὀϊλῆα	---------	n-s---ma-,n-s---ma-
τοῖιν	p-d---mg-	l-d---mg-,l-d---ng-,l-d---md-,l-d---nd-
μενεχάρμην	a-s---ma-	n-s---ma-
ἐριαύχενες	a-p---mn-	n-p---mn-,n-p---fn-,n-p---mv-,n-p---fv-
ὑπόεικε	v2spma---	v3siia---
Κισσῆς	n-s---mn-	n-p---mn-,n-p---mn-,n-p---mv-,n-s---fg-,v2spia---,v2spia---
Περκώτῃ	n-s---fd-	n-s---md-
ἀντομένη	v-sppefn-	v-sppmfn-,v-sppmfv-
καθαλλομένη	v-sppefn-	v-sppmfn-,v-sppmfv-
βόλεται	v3spie---	v3spim---
αὐλῶπις	a-s---fn-	n-s---fn-
μηκάδες	a-p---mn-	n-p---fn-,n-p---fv-
λωβητὴρ	n-s---mv-	n-s---mn-
πλέες	a-p---mn-	v2siia---
ἀσπιστάων	a-p---mg-	n-p---mg-
Ἱππάσου	---------	n-s---mg-
ὠμησταὶ	a-p---mn-	n-p---mn-,n-p---mv-
ἀνέσσυτο	v3siie---	v3siim---
σίντην	a-s---ma-	n-s---ma-
ἐντροπαλιζόμενος	v-sppamn-	v-sppemn-,v-sppemn-
λιλαιόμενα	v-pppenn-	v-pppmnn-,v-pppmnv-,v-pppmna-
ἀπαινύμενον	v-sppema-	v-sppmma-,v-sppmnn-,v-sppmnv-,v-sppmna-
ἱδρῶσαι	v-pppafn-	v--ana---
ἰῶκά	n-s---fa-	n-s---ma-
τίπτέ	p--------	n--------
ἔρειο	v2spma---	v2sa-m---
κυανόπεζαν	a-s---fa-	n-s---fa-
Ἠλείοισι	n-p---md-	a-p---md-,a-p---nd-
Νηλεύς	n-s---mn-	n-s---fn-
χαλκοχίτωνες	a-p---mn-	n-p---mn-,n-p---fn-,n-p---mv-,n-p---fv-
πολεῖς	a-p---mn-	v2spia---
μώνυχες	a-p---mn-	n-p---mn-,n-p---fn-,n-p---mv-,n-p---fv-
Βουπρασίου	n-s---ng-	n-s---mg-
Βουπρασίοιο	n-s---ng-	n-s---mg-
Φθίης	---------	a-s---fg-,n-s---fg-,a-s---fg-
δειδίσσετο	v3siie---	v3siim---
Ἄσιον	n-s---mn-	a-s---ma-,a-s---nn-,a-s---nv-,a-s---na-,a-s---ma-,a-s---nn-,a-s---nv-,a-s---na-,v3piia---,v1siia---,v3piia---,v1siia---
ἐπεσσυμένους	v-pppema-	v-prpmma-,v-pppmma-,v-prpema-,v-prpema-
τανυπτερύγεσσι	a-p---md-	n-p---md-,n-p---fd-
προβλῆτας	a-p---fa-	n-p---ma-,n-p---fa-
ἄλλά	a-p---nn-	p-p---nn-,p-p---nv-,p-p---na-,p-d---fn-,p-d---fv-,p-d---fa-,p-s---fn-,p-s---fv-
ἕλιξιν	a-p---md-	n-p---md-,n-p---fd-,n-p---fd-
καυστείρης	a-s---fg-	n-s---fg-
θωρηκτάων	a-p---mg-	n-p---mg-
εἴρυντο	v3piie---	v3piim---,v3plie---,v3piim---
δικλίδας	a-p---fa-	n-p---fa-
ἐσχεθέτην	v3diia---	v3daia---
Ἀβίων	---------	n-p---mg-,a-p---mg-,a-p---fg-,a-p---ng-,v-sppamn-
Ἴμβρου	n-s---fg-	n-s---mg-
Ὀϊλῆος	---------	n-s---mg-,n-s---mg-
εἰδόμενος	v-sppemn-	v-sppmmn-
ἔσσυμαι	v1spie---	v1spim---
Λήϊτον	---------	n-s---ma-,n-s---nn-,n-s---nv-,n-s---na-
Ὀϊλιάδης	---------	n-s---mn-
ὑπερηνορέοντος	a-s---mg-	n-s---mg-
ἀποαίνυμαι	v1spie---	v1spim---
ὀρώρηται	v3spse---	v3spsm---
ἄλλόν	a-s---ma-	p-s---ma-
ἱεμένοιο	v-sppemg-	v-sppmmg-,v-sppmng-
δεξιόφιν	d--------	a-p---md-,a-p---nd-
ἐτεύχετον	v3diia---	v2diia---
ὑποσχόμενοι	v-papamn-	v-papmmn-,v-papmmv-,v-papmmn-,v-papmmv-
μενεχάρμης	a-s---mn-	n-s---mn-
νώροπι	a-s---md-	n-s---md-,n-s---fd-
κτίλον	n-s---ma-	a-s---ma-,a-s---fa-,a-s---nn-,a-s---nv-,a-s---na-
γάνυται	v3spie---	v3spim---
θυμοραϊστής	a-s---mn-	n-s---mn-
σκῶλος	n-s---fn-	n-s---mn-
πτυόφιν	n-s---ng-	n-p---nd-
ἐσσύμενοί	v-pppemn-	a-p---mn-,a-p---mv-,v-prpmmn-,v-prpmmv-,v-pppmmn-,v-pppmmv-,v-prpemn-,v-prpemv-
τροίην	n-s---fa-	v1spoa---
ἑλκεχίτωνες	a-p---mn-	n-p---mn-,n-p---mv-
Φθῖοι	n-p---mn-	a-p---mn-,a-p---mv-,a-p---mn-,a-p---mv-
χαλκοκορυστῇ	a-s---md-	n-s---md-
ἀνάλκιδα	a-s---ma-	n-s---fa-
δειδίσσεαι	v2spie---	v2spim---
συνεέργαθον	v3piia---	v3paia---,v1saia---,v3paia---,v1saia---
δερκομένῳ	v-sppemd-	v-sppmmd-,v-sppmnd-
ὁπλοτεράων	a-p---fgc	a-p---mg-,a-p---fg-
Λεκτόν	n-s---na-	n-s---ma-,a-s---ma-,a-s---nn-,a-s---nv-,a-s---na-
ὀξύτατον	a-s---nns	a-s---ma-,a-s---nn-,a-s---nv-,a-s---na-
φύεν	-3siia---	v--pna---,v3paip---
Σάτνιον	n-s---ma-	n-s---nn-,n-s---nv-,n-s---na-
Σατνιόεντος	a-s---mg-	n-s---mg-
φὴ	v3siia---	d--------,x--------
ἀφήμενος	v-srpemn-	v-srpmmn-
δειδισσέσθω	v3spme---	v3spmm---
γνωτοί	n-p---mn-	a-p---mn-,a-p---mv-,a-p---mn-,a-p---fn-,a-p---mv-,a-p---fv-,n-p---fn-,n-p---fv-
γνωταί	n-p---fn-	a-p---fn-,a-p---fv-
ἀλλήλοισί	a-p---md-	p-p---nd-,p-p---md-
ἔκτοθι	r--------	d--------
ἀγαπήνορος	a-s---mg-	n-s---mg-
δαήμονος	a-s---mg-	a-s----g-
ἱεμένη	v-sppefn-	v-sppmfn-,v-sppmfv-
ἀπαίνυτο	v3siie---	v3siim---
κορωνίσι	a-p---fd-	n-p---fd-
ἀήτη	n-s---mn-	n-s---fn-,n-s---fv-,n-s---mv-
ὀλοόφρων	a-s---mn-	n-s---mn-,n-s---fn-,n-s---mv-,n-s---fv-
ἕλικος	a-s---fg-	n-s---mg-,n-s---fg-,n-s---fg-
ἀκμῆτας	a-p---ma-	n-p---ma-,n-p---fa-
εἱανοῦ	n-s---mg-	a-s---mg-,a-s---ng-
εὐτείχεα	a-s---fa-	a-p---nn-,a-p---nv-,a-p---na-
λιλαίεσθαι	v--pne---	v--pnm---
ἀσπιδιώτας	a-p---ma-	n-p---ma-,n-s---mn-
Ἐχεκλῆος	n-s---mn-	n-s---mg-
ἕης	p-s---fg-	v2spia---
ἀνιπτόποδες	n-p---mn-	a-p---mn-,a-p---fn-,a-p---mv-,a-p---fv-
εἴδοντο	v3piie---	v3piim---,v3piim---,v3paim---
πάχιστος	a-s---mns	a-s---mn-
ἀπετίνυτο	v3siie---	v3siim---
προβλῆτι	a-s---fd-	n-s---md-,n-s---fd-,n-s---fv-
νείαιραν	a-s---fa-	n-s---fa-
ὀξείῃς	a-s---fd-	a-p---fd-
ἑλίκωπας	a-p---ma-	n-p---ma-,n-p---fa-
ἀργυρόπεζαν	a-s---fa-	n-s---fa-
ἐνισκίμφθη	v3saip---	v3saie---
Πατρόκλεις	n-s---mv-	n-p---mv-
Ἀσίῳ	n-s---md-	a-s---md-,a-s---nd-,a-s---md-,a-s---nd-
μάρμαρον	a-s---ma-	n-s---nn-,n-s---nv-,n-s---na-,n-s---ma-
ἐϋμμελίης	a-s---mn-	n-s---mn-
ἐϋμμελίαι	a-p---mn-	n-p---mn-,n-p---mv-,n-s---md-
ἐϋμμελίην	a-s---ma-	n-s---ma-
ἐνείη	v3spoa---	v3saoa---,v3saoa---
πολέσσιν	a-p---md-	a-p---m--,a-p---n--
ἱέμενοί	v-pppemn-	v-pppmmn-,v-pppmmv-
πότι	r--------	n-s---fv-,n-s---fv-
Φόρκυνα	n-s---ma-	n-s---fa-
ἐελποίμην	v1spoe---	v1spom---
καλλίτριχε	n-d---ma-	a-d---mn-,a-d---fn-,a-d---mv-,a-d---fv-,a-d---ma-,a-d---fa-,a-s---mv-,a-s---fv-
νειαίρῃ	a-s---fd-	n-s---fd-,n-s---fd-
καταπέφνων	v-sapamn-	v-sppamn-
πολύδακρυς	a-s---fn-	n-s---mn-,n-s---fn-
πάμπρωτα	a-p---nas	a-p---nn-,a-p---nv-,a-p---na-
Ἀψευδὴς	n-s---fn-	n-s---mn-,a-s---mn-,a-s---fn-
σπῆϊ	n-s---nd-	v2sase---,v3sasa---,v2spse---,v2spie---,v3spsa---,v3spia---
καλλιπλοκάμῳ	a-s---fd-	n-s---md-,n-s---fd-
ῥαιστῆρα	n-s---fa-	n-s---ma-
τρίπλακα	a-s---fa-	n-s---ma-,n-s---fa-
ἰθύντατα	d-------s	d--------
βότρυες	n-p---mn-	n-p---fn-,n-p---fv-
ἀπετρωπῶντο	v3piia---	v3piie---
πυμάτην	a-s---fas	a-s---fa-
χαλκοτύπους	a-p---fa-	a-p---ma-,n-p---ma-
Λυρνησσὸν	n-s---ma-	n-s---fa-
ἠεροφοῖτις	a-s---fn-	n-s---fn-
πίλναται	v3spie---	v3spim---
κράατα	n-p---na-	n-p---nn-
νήστιας	a-p---ma-	n-p---ma-,n-p---fa-
πιείρῃ	a-s---fd-	n-s---fd-
αἴθωνας	a-p---ma-	n-p---ma-,n-p---fa-
τίνυνται	v3ppie---	v3ppim---
τανυπτέρυγι	a-s---fd-	n-s---md-,n-s---fd-
ἐκκατεπᾶλτο	v3saim---	v3saie---
ἵππουρις	a-s---fn-	n-s---fn-
μελίφρων	a-s---mn-	n-s---mn-,n-s---fn-,n-s---mv-,n-s---fv-
πολύαρνι	a-s---md-	n-s---md-,n-s---fd-
πλέας	a-p---ma-	a-p---fa-,a-s---fg-,a-p---fa-,a-s---fg-
δειδίσσεσθαι	v--pne---	v--pnm---
φολκὸς	a-s---mn-	n-s---mn-
ἀγοράασθε	v2ppie---	v2piim---,v2ppmm---,v2ppim---,v2piim---,v2pfim---
αἰθαλόεν	a-s---na-	a-s---mv-,a-s---nn-,a-s---nv-
Ἀνθηδόνα	n-s---fa-	n-s---ma-
Λάαν	n-s---fa-	n-s---nv-,v--pna---,v--pna---,v--pna---,v--pna---
Πτελεὸν	n-s---ma-	n-s---nn-,n-s---nv-,n-s---na-
Δώριον	n-s---na-	a-s---ma-,a-s---nn-,a-s---nv-,a-s---na-,a-s---ma-,a-s---fa-,a-s---nn-,a-s---nv-,a-s---na-,v3piia---,v1siia---
ἀντόμεναι	v-pppefn-	v-pppmfn-,v-pppmfv-
Φενεόν	n-s---ma-	n-s---fa-
Βουπράσιόν	n-s---na-	n-s---ma-
Κνωσόν	n-s---ma-	n-s---fa-
Γόρτυνά	n-s---fa-	n-s---fn-,n-s---fv-,n-s---ma-
ἀργινόεντα	a-s---fa-	a-p---nn-,a-p---nv-,a-p---na-,a-s---ma-
Ῥύτιόν	n-s---na-	n-s---fa-
ἑκατόμπολιν	n-s---fa-	n-s----a-
Λυρνησσοῦ	n-s---mg-	n-s---fg-
Βοιβηΐδα	a-s---fa-	n-s---fa-
Ἰαωλκόν	n-s---fa-	n-s---ma-
Ὀλιζῶνα	n-s---fa-	n-s---ma-
Ἀστέριον	n-s---na-	n-s---ma-,a-s---ma-,a-s---nn-,a-s---nv-,a-s---na-
Τιταρησσὸν	n-s---ma-	n-s---fa-
ὄτριχας	n-p---fa-	a-p---ma-,a-p---fa-
Ἀρίμοις	n-p---md-	a-p---md-,a-p---nd-
Περκώτην	n-s---fa-	n-s---ma-
Φθιρῶν	n-p---mg-	n-p---fg-,n-p---fg-
ἀκερσεκόμης	a-s---mn-	n-s---mn-
βαθυδίνης	a-s---mn-	n-s---mn-
λιλαίετο	v3siie---	v3siim---
ὑπίσχεο	v2saim---	v2siie---,v2spme---,v2siie---
χερείονος	a-s---mg-	n-s---mg-,n-s---fg-
σίντης	a-s---mn-	n-s---mn-
ληϊάδας	a-p---fa-	n-p---fa-
καλλιπλοκάμου	a-s---fg-	n-s---mg-,n-s---fg-
ὑποείκειν	v--pna---	v1slia---,v--rna---
Πηλιὰς	a-s---fn-	n-s---fn-,n-s---fn-
δάηται	v3sasm---	v3sase---
δατέοντο	v3piie---	v3piim---
γαίη	n-s---fd-	n-s---fn-,n-s---fv-
ἀνεπᾶλτο	v3saim---	v3saie---
ἄρσενας	a-p---ma-	n-p---ma-,n-p---fa-
γοήσεται	v3sfim---	v3sasm---
ἀργέτα	a-s---ma-	n-s---ma-
ἀργυροδίνης	a-s---mn-	n-s---mn-
ἰθυπτίωνα	a-s---fa-	n-s---ma-,n-s---fa-
ἱπποκορυστάς	a-p---ma-	n-p---ma-,n-s---mn-
ἔνθορε	v3saia---	a-s---mv-,a-s---fv-
καῖ̓	v2spma---	c--------
ἐθείρῃ	v3spsa---	n-s---fd-
πολυμήτιος	a-s---mg-	n-s---mg-,n-s---fg-
κατέσσυτο	v3siie---	v3siim---
μετέσσυτο	v3siie---	v3siim---
θωρηκτῇσιν	a-p---md-	n-p---md-
ἀγήνορι	a-s---md-	n-s---md-,n-s---fd-
ἐντροπαλιζομένην	v-sppafa-	v-sppefa-,v-sppefa-
συναίνυτο	v3siie---	v3siim---
Ἰλήϊον	a-s---na-	n-s---ma-
ξυμβλήμεναι	v--anm---	v-papmfn-,v-papmfv-
ἐφέψεις	v2sfia---	v2spia---,v2siia---,v2siia---,v2siia---
τραπεζῆας	a-p---ma-	n-p---ma-
ἀνιεμένη	v-sppefn-	v-sppmfn-,v-sppmfv-
ὑπόσχωμαι	v1sasa---	v1sase---,v1sasm---
ἄμπνυε	v2sama---	v3siia---
δίον	v1saia---	v-sppamv-,v-sppann-,v-sppanv-,v-sppana-,v-sppamv-,v-sppann-,v-sppanv-,v-sppana-,v3piia---,v1siia---
ὑπόσχωνται	v3pasa---	v3pase---,v3pasm---
γαλόῳ	n-p---fn-	n-p---mn-,n-s---md-
Πλάκῳ	n-s---fd-	n-s---md-
ἐπήν	d--------	c--------
Ὀπόεντος	n-s---mg-	n-s---fg-,a-s---mg-,a-s---ng-
δίπλακι	a-s---md-	n-s---md-,n-s---fd-
τρίποδάς	n-p---ma-	a-p---ma-,a-p---fa-
ἕστατον	v3dria---	v2dlia---,v2drma---,v2dria---
ὔμμε	p-p---ma-	p2p----a-,a-s---mv-
ἐκδέρκεται	v3spie---	v3spim---
λαβραγόρην	a-s---ma-	n-s---ma-
ἀέθλιον	n-s---na-	a-s---ma-,a-s---nn-,a-s---nv-,a-s---na-,a-s---ma-,a-s---fa-,a-s---nn-,a-s---nv-,a-s---na-,a-s---ma-,a-s---nn-,a-s---nv-,a-s---na-,v3piia---,v1siia---,v3piia---,v1siia---
Βουπρασίῳ	n-s---nd-	n-s---md-
ἐμπυριβήτην	a-s---ma-	n-s---ma-
ἱεμένῳ	v-sppemd-	v-sppmmd-,v-sppmnd-
ταμεσίχροα	a-s---ma-	n-s---ma-,n-s---fa-
περιπλομένους	v-pppema-	v-pppmma-
ἀελλόπος	n-s---fn-	a-s---mn-,a-s---fn-,a-s---mv-,a-s---fv-
μείλανι	a-s---md-	a-s----d-
μελάντερον	a-s---nnc	a-s---ma-,a-s---nn-,a-s---nv-,a-s---na-
ὀμφαλόεν	a-s---na-	a-s---mv-,a-s---nn-,a-s---nv-
ἐφιεμένῃ	v-sppefd-	v-sppmfd-
Ἰδαῖος	n-s---ma-	a-s---mn-
φίλτατόν	a-s---nns	a-s---ma-,a-s---nn-,a-s---nv-,a-s---na-
Ἰδαῖον	n-s---ma-	a-s---ma-,a-s---nn-,a-s---nv-,a-s---na-
δοιώ	a-d---mn-	d--------
γαλόων	n-p---fg-	n-p---mg-,n-s---ma-
ἄξετε	v2pama---	v2pasa---,v2pfia---,v2pasa---,v2paia---,v2pfia---,v2paia---
λάρνακα	n-s---fa-	n-s---ma-
ἕαται	v3prie---	v3prim---
μάκαρ	a-s---mv-	n-s---mn-,n-s---fn-
ἀντιάνειραι	a-p---fn-	n-p---fn-,n-p---fv-
κτίλος	n-s---mn-	a-s---mn-,a-s---fn-
τίνυσθον	v2dpie---	v3dpim---,v2dpim---,v2diim---
δερκόμενοι	v-pppemn-	v-pppmmn-,v-pppmmv-
ἀπόεικε	v2spma---	v3siia---,v3siia---
καθήμεναι	v-prpefn-	v-prpmfn-,v-prpmfv-
δειδίσσεο	v2spme---	v2spmm---,v2siim---
Πειραΐδαο	---------	n-s---mg-
πόλεας	n-p---fa-	a-p---ma-
κατέκταν	v1saia---	v3paia---
ἀκουάζεσθον	v2diie---	v2diim---,v2dpmm---,v3dpim---,v2dpim---,v2diim---
τέττα	x--------	i--------
Αἰνόθεν	---------	d--------,d--------
ἀπεσσύμενον	v-sppema-	v-srpmma-,v-srpmnn-,v-srpmnv-,v-srpmna-,v-sppmma-,v-sppmnn-,v-sppmnv-,v-sppmna-,v-srpema-,v-srpenn-,v-srpenv-,v-srpena-
ἀρητὴρ	n-s---mn-	n-s---fn-
ἐξάλλεται	v3spie---	v3spim---
αὐλώπιδί	---------	n-s---fd-
θήλεας	a-p---fa-	a-p---ma-
σφῶΐ	p-d---ma-	v3sfoa---,a-s---md-,a-s---nd-,p2d----n-,p2d----a-
ἀνάλκιδας	a-p---fa-	n-p---fa-
χρυσάμπυκας	a-p---ma-	n-p---ma-,n-p---fa-
Ἑρμέᾳ	n-s---md-	n-p----n-,n-p----v-,n-p---mv-
ωὐτὸς	a-s---mn-	p-s---mn-
ἀπάτερθεν	r--------	d--------
ἔνειμεν	v1ppia---	v3saia---
ἀδαήμονι	a-s---md-	a-s----d-
ὀστέω	n-s---nd-	n-d---nn-,n-d---nv-,n-d---na-,n-s---ng-
αἰολομίτρην	a-s---ma-	n-s---ma-
ἐξαποδίωμαι	v1spie---	v1spse---,v1sasm---,v1spse---,v1spse---,v1spsm---,v1spse---
τρήρωσι	a-p---fd-	n-p---md-,n-p---fd-
πολυᾶϊξ	a-s---mn-	n-s---mn-,n-s---fn-
ἀνώγειν	v3slia---	v1slia---,v1slia---,v--rna---,v--pna---,v1slia---
Δρῆσον	n-s---ma-	n-s---nn-,n-s---nv-,n-s---na-,v2sama---
Μηκιστηϊάδης	---------	n-s---mn-
μυρικίνῳ	---------	n-s---md-
ὑποσχέσθαι	v--ana---	v--anm---,v--anm---
βασιληΐδος	---------	n-s---fg-
μετεσσεύοντο	v3paia---	v3piie---
Κισσηῒς	a-s---fn-	n-s---fn-
παρακοίτης	n-s---mn-	n-p---fn-,n-p---fv-,v2siia---
Μεσσηΐδος	---------	n-s---fg-
δακρυόεν	a-s---na-	a-s---mv-,a-s---nn-,a-s---nv-
ἐντροπαλιζομένη	v-sppafn-	v-sppefn-,v-sppefv-,v-sppefn-,v-sppefv-
Ἀρηϊθόοιο	---------	n-s---mg-,a-s---mg-,a-s---fg-,a-s---ng-,a-s---mg-,a-s---fg-,a-s---ng-
Ἀρηΐθοος	---------	n-s---mn-,a-s---mn-,a-s---fn-,a-s---mn-,a-s---fn-
Δεξιάδην	n-s---ma-	n-s---fa-
χαλκοκνήμιδες	a-p---mn-	n-p---mn-,n-p---fn-,n-p---mv-,n-p---fv-
σύλησας	v-sapamn-	v2saia---
ἀκλεὲς	a-p---mn-	a-s---mv-,a-s---fv-,a-s---nn-,a-s---nv-,a-s---na-
Ἀρηϊθόου	---------	n-s---mg-,a-s---mg-,a-s---fg-,a-s---ng-,a-s---mg-,a-s---fg-,a-s---ng-
ἠπύτα	a-s---mn-	n-s---mn-
ἄλλός	a-s---mn-	p-s---mn-
τεοῖο	p-s----g-	p2s----g-,a-s---mg-,a-s---ng-
ἀνέπαλτο	v3saia---	v3saim---
ἀγαπήνωρ	a-s---mn-	n-s---mn-
ἠγοράασθε	v2piie---	v2piim---
Δαίτορά	n-s---ma-	n-s---fn-,n-s---fv-
τανυγλώχινας	a-p---ma-	n-p---ma-,n-p---fa-
ἀντικρύ	r--------	d--------
πληγέντε	v-dappfn-	v-dappmn-,v-dappnn-,v-dappmv-,v-dappnv-,v-dappma-,v-dappna-,v-dappmn-,v-dappnn-,v-dappmv-,v-dappnv-,v-dappma-,v-dappna-
ἄξεσθε	v2ppme---	v2pfim---,v2paim---,v2pfim---,v2paim---
εἴατο	v3piie---	v3slie---,v3piim---
πολύρρηνες	a-p---mn-	n-p---mn-,n-p---fn-,n-p---mv-,n-p---fv-
πολυβοῦται	a-p---mn-	n-p---mn-,n-p---mv-
ἀπτῆσι	a-p---md-	n-p---md-,n-p---fd-
τρίποδές	n-p---mn-	a-p---mn-,a-p---fn-,a-p---mv-,a-p---fv-
ἀπόφασθε	v2ppme---	v2ppmm---
παραβλῶπές	a-p---fn-	n-p---mn-,n-p---fn-,n-p---mv-,n-p---fv-
Κουρῆτές	n-p---mn-	n-p---fn-,n-p---fv-
μενεχάρμαι	a-p---mn-	n-p---mn-,n-p---mv-,n-s---md-
ἀργιόδοντα	a-s---ma-	n-s---ma-,n-s---fa-
ἀπέχθηαι	v2sasa---	v2spse---,v2sase---
ἀναίνεται	v3spie---	v3spim---
παλαίτερα	a-p---nac	a-p---nn-,a-p---nv-,a-p---na-
ξυνήθη	a-s---fa-	v3siia---,v2spma---,v3siia---
ἐφιέμενοι	v-pppemn-	v-pppmmn-,v-pppmmv-
Ἀττικῇ	n-s---fd-	a-s---fd-
προσκαθεζόμενοι	v-pppemn-	v-pppmmn-,v-pppmmv-
ἐλάσσονί	a-s---mdc	a-s----dc
Κερκυραίους	n-p---ma-	a-p---ma-
Κερκυραίοις	n-p---md-	a-p---md-,a-p---nd-
Δωριῶν	n-p---mg-	v-sfpamn-,v-sfpamv-,v-sfpann-,v-sfpanv-,v-sfpana-,v-sfpamn-,v-sfpamv-,v-sfpann-,v-sfpanv-,v-sfpana-,v-sfpamn-
τοσαίδε	a-p---fn-	p-p---fn-
Ταυλάντιοι	n-p---mn-	a-p---mn-,a-p---mv-
Ἐπιδαμνίων	n-p---mg-	a-p---fg-,a-p---mg-,a-p---ng-
Ἐπιδάμνιοι	n-p---mn-	a-p---mn-,a-p---mv-
Κερκυραίων	n-p---mg-	a-p---fg-,a-p---mg-,a-p---ng-
προύχειν	v--pna---	v1slia---,v--rna---
Ἐπίδαμνον	n-s---fa-	n-s---ma-
Λευκαδίων	n-p---mg-	a-p---fg-,a-p---mg-,a-p---ng-
Ἀπολλωνίαν	n-s---fa-	a-s---fa-
Ἐπιδαυρίων	n-p---mg-	a-p---fg-,a-p---mg-,a-p---ng-
Τροιζήνιοι	n-p---mn-	a-p---mn-,a-p---mv-
Λευκάδιοι	n-p---mn-	a-p---mn-,a-p---mv-
Φλειασίους	n-p---ma-	a-p---ma-
Ἐπιδάμνῳ	n-s---fd-	n-s---md-
Κερκυραίας	n-s---fg-	a-p---fa-,a-s---fg-
Ἠλείων	n-p---mg-	a-p---fg-,a-p---mg-,a-p---ng-
αἰσθάνεται	v3spie---	v3spim---
πλέονι	a-s---fdc	a-s----dc
βραχυτάτῳ	a-s---nds	a-s---md-,a-s---nd-
πλέοσιν	a-p---mdc	a-p----dc
πρεσβυτέρου	a-s---mgc	a-s---mg-,a-s---ng-
Λακεδαιμόνιός	n-s---mn-	a-s---mn-
Πρωτέας	n-s---mn-	n-p---ma-,n-p---ma-
Ἀνακτορίων	n-p---mg-	a-p---fg-,a-p---mg-,a-p---ng-,a-p---fg-,a-p---mg-,a-p---ng-
Ἀχερουσία	n-s---fn-	a-d---fn-,a-d---fv-,a-d---fa-,a-s---fn-,a-s---fv-
Ζακυνθίων	n-p---mg-	a-p---fg-,a-p---mg-,a-p---ng-
ἐλάσσονος	a-s---ngc	a-s----gc
Ἀνακτόριον	n-s---na-	a-s---ma-,a-s---nn-,a-s---nv-,a-s---na-,a-s---ma-,a-s---nn-,a-s---nv-,a-s---na-
Βοττιαίοις	n-p---md-	a-p---md-,a-p---nd-,a-p---md-,a-p---nd-
Βοττιαίων	n-p---mg-	a-p---fg-,a-p---mg-,a-p---ng-,a-p---fg-,a-p---mg-,a-p---ng-
Σερμυλιῶν	n-p---mg-	a-p---fg-,a-p---mg-,a-p---ng-
Χαλκιδικὴν	n-s---fa-	a-s---fa-,a-s---fa-
προῆσθε	v2pasa---	v2ppsa---
αἰσθανομένων	v-pppemg-	v-pppmfg-,v-pppmmg-,v-pppmng-
αἰσθανόμενοι	v-pppemn-	v-pppmmn-,v-pppmmv-
πλέονος	a-s---ngc	a-s----gc
ἐκείνως	d-p---ma-	p-p---ma-,v2siia---
κρείσσονος	a-s---ngc	a-s----gc
δῃοῦν	v3piia---	v-sppamv-,v-sppann-,v-sppanv-,v-sppana-,v--pna---,v-sppamv-,v-sppann-,v-sppanv-,v-sppana-,v--pna---
σχολαίτερον	a-s---nac	a-s---ma-,a-s---nn-,a-s---nv-,a-s---na-
ξυγγραφῇ	n-s---fd-	v3sasp---
Καρυστίους	n-p---ma-	a-p---ma-
Ναξίοις	n-p---md-	a-p---md-,a-p---nd-,v2sfoa---
Θασίους	n-p---ma-	a-p---ma-
Ἠδωνικῇ	n-s---fd-	a-s---fd-
Ἰνάρως	n-s---mn-	n-s----n-
Ἐπιδαυρίους	n-p---ma-	a-p---ma-
ᾐσθάνοντο	v3piie---	v3piim---
Σικυωνίους	n-p---ma-	a-p---ma-,a-p---ma-
Ἑστιαιᾶς	n-p---ma-	n-p---fa-,n-s---fg-,n-s---fg-
Μιλησίοις	n-p---md-	a-p---md-,a-p---nd-
Καύνου	n-s---fg-	n-s---mg-
ξυνόδου	n-s---fg-	v2spma---,v3siia---
τοσάσδε	a-p---fa-	p-p---fa-
ξυμφορῶν	n-p---fg-	v-sppamn-
μεγίστῃ	a-s---fds	a-s---fd-
Διάσια	a-s---fn-	n-p---nn-,n-p---nv-,n-p---na-
μειζόνως	d-------c	d--------
τρίποδά	n-s---ma-	a-p---nn-,a-p---nv-,a-p---na-,a-s---ma-,a-s---fa-
Ἀργίλιος	n-s---mn-	a-s---mn-
προσκαθεζόμενοί	v-pppemn-	v-pppmmn-,v-pppmmv-
Μολοσσῶν	n-p---mg-	a-p---mg-,a-p---fg-,a-p---ng-
ᾗπερ	a-s---fd-	c--------
πλέοσι	a-p---mdc	a-p----dc
ἐλάσσοσι	a-p---mdc	a-p----dc
αὐτονομεῖσθαι	v--pne---	v--pnm---
